home_team,away_team,home_score,away_score,tournament,country,day,month,year,home_result,away_result,total_goals,serial,home_group,away_group,home_team_txt,away_team_txt,year_n,result,home_random,away_random,decade,home_result_desc,away_result_desc
Wales,England,1,1,British Championship,Wales,26,3,1900,0,0,2,1,0,1,Wales,England,0,0,0.18888,0.85962,1,draw,draw
England,Wales,6,0,British Championship,England,18,3,1901,6,-6,6,2,1,0,England,Wales,1,6,0.51046,0.42962,1,winner,loser
Wales,England,0,0,British Championship,Wales,3,3,1902,0,0,0,3,0,1,Wales,England,2,0,0.72553,0.86847,1,draw,draw
Uruguay,Argentina,0,6,Friendly,Uruguay,20,7,1902,-6,6,6,4,1,1,Uruguay,Argentina,2,6,0.29914,0.59445,1,loser,winner
England,Wales,2,1,British Championship,England,2,3,1903,1,-1,3,5,1,0,England,Wales,3,1,0.73497,0.00818,1,winner,loser
Argentina,Uruguay,2,3,Friendly,Argentina,13,9,1903,-1,1,5,6,1,1,Argentina,Uruguay,3,1,0.60888,0.88934,1,loser,winner
Wales,England,2,2,British Championship,Wales,29,2,1904,0,0,4,7,0,1,Wales,England,4,0,0.01183,0.35252,1,draw,draw
Belgium,France,3,3,Friendly,Belgium,1,5,1904,0,0,6,8,1,0,Belgium,France,4,0,0.24535,0.70093,1,draw,draw
France,Switzerland,1,0,Friendly,France,12,2,1905,1,-1,1,9,0,0,France,Switzerland,5,1,0.62015,0.56337,1,winner,loser
England,Wales,3,1,British Championship,England,27,3,1905,2,-2,4,10,1,0,England,Wales,5,2,0.23281,0.91892,1,winner,loser
Belgium,Netherlands,1,4,Friendly,Belgium,30,4,1905,-3,3,5,11,1,1,Belgium,Netherlands,5,3,0.63549,0.53813,1,loser,winner
Belgium,France,7,0,Friendly,Belgium,7,5,1905,7,-7,7,12,1,0,Belgium,France,5,7,0.64401,0.02658,1,winner,loser
Netherlands,Belgium,4,0,Friendly,Netherlands,14,5,1905,4,-4,4,13,1,1,Netherlands,Belgium,5,4,0.81216,0.17188,1,winner,loser
Argentina,Uruguay,0,0,Copa Lipton,Argentina,15,8,1905,0,0,0,14,1,1,Argentina,Uruguay,5,0,0.9011,0.35862,1,draw,draw
Wales,England,0,1,British Championship,Wales,19,3,1906,-1,1,1,15,0,1,Wales,England,6,1,0.30448,0.58617,1,loser,winner
France,Belgium,0,5,Friendly,France,22,4,1906,-5,5,5,16,0,1,France,Belgium,6,5,0.39137,0.16348,1,loser,winner
Belgium,Netherlands,5,0,Friendly,Belgium,29,4,1906,5,-5,5,17,1,1,Belgium,Netherlands,6,5,0.85972,0.03792,1,winner,loser
Netherlands,Belgium,2,3,Friendly,Netherlands,13,5,1906,-1,1,5,18,1,1,Netherlands,Belgium,6,1,0.31951,0.98711,1,loser,winner
Uruguay,Argentina,0,2,Copa Lipton,Uruguay,15,8,1906,-2,2,2,19,1,1,Uruguay,Argentina,6,2,0.72405,0.00968,1,loser,winner
Argentina,Uruguay,2,1,Copa Newton,Argentina,21,10,1906,1,-1,3,20,1,1,Argentina,Uruguay,6,1,0.43289,0.10853,1,winner,loser
England,Wales,1,1,British Championship,England,18,3,1907,0,0,2,21,1,0,England,Wales,7,0,0.94094,0.13946,1,draw,draw
Belgium,Netherlands,1,3,Friendly,Belgium,14,4,1907,-2,2,4,22,1,1,Belgium,Netherlands,7,2,0.64182,0.95946,1,loser,winner
Belgium,France,1,2,Friendly,Belgium,21,4,1907,-1,1,3,23,1,0,Belgium,France,7,1,0.08541,0.03219,1,loser,winner
Netherlands,Belgium,1,2,Friendly,Netherlands,9,5,1907,-1,1,3,24,1,1,Netherlands,Belgium,7,1,0.96616,0.39144,1,loser,winner
Switzerland,France,1,2,Friendly,Switzerland,8,3,1908,-1,1,3,25,0,0,Switzerland,France,8,1,0.4805,0.15903,1,loser,winner
Wales,England,1,7,British Championship,Wales,16,3,1908,-6,6,8,26,0,1,Wales,England,8,6,0.68501,0.69785,1,loser,winner
Belgium,Netherlands,1,4,Friendly,Belgium,29,3,1908,-3,3,5,27,1,1,Belgium,Netherlands,8,3,0.33947,0.65572,1,loser,winner
Switzerland,Germany,5,3,Friendly,Switzerland,5,4,1908,2,-2,8,28,0,1,Switzerland,Germany,8,2,0.7869,0.76033,1,winner,loser
France,Belgium,1,2,Friendly,France,12,4,1908,-1,1,3,29,0,1,France,Belgium,8,1,0.12137,0.04366,1,loser,winner
Netherlands,Belgium,3,1,Friendly,Netherlands,26,4,1908,2,-2,4,30,1,1,Netherlands,Belgium,8,2,0.81934,0.8281,1,winner,loser
Netherlands,France,4,1,Friendly,Netherlands,10,5,1908,3,-3,5,31,1,0,Netherlands,France,8,3,0.74209,0.12457,1,winner,loser
Uruguay,Argentina,2,2,Copa Lipton,Uruguay,15,8,1908,0,0,4,32,1,1,Uruguay,Argentina,8,0,0.48291,0.43999,1,draw,draw
Argentina,Uruguay,2,1,Copa Newton,Argentina,13,9,1908,1,-1,3,33,1,1,Argentina,Uruguay,8,1,0.73164,0.15123,1,winner,loser
Argentina,Uruguay,0,1,Copa Premio Honor Argentino,Argentina,4,10,1908,-1,1,1,34,1,1,Argentina,Uruguay,8,1,0.01594,0.18676,1,loser,winner
England,Wales,2,0,British Championship,England,15,3,1909,2,-2,2,35,1,0,England,Wales,9,2,0.34003,0.82075,1,winner,loser
Belgium,Netherlands,1,4,Friendly,Belgium,21,3,1909,-3,3,5,36,1,1,Belgium,Netherlands,9,3,0.79134,0.22508,1,loser,winner
Germany,Switzerland,1,0,Friendly,Germany,4,4,1909,1,-1,1,37,1,0,Germany,Switzerland,9,1,0.89395,0.46182,1,winner,loser
Netherlands,Belgium,4,1,Friendly,Netherlands,25,4,1909,3,-3,5,38,1,1,Netherlands,Belgium,9,3,0.50579,0.89458,1,winner,loser
Belgium,France,5,2,Friendly,Belgium,9,5,1909,3,-3,7,39,1,0,Belgium,France,9,3,0.83698,0.43885,1,winner,loser
Argentina,Uruguay,2,1,Copa Lipton,Argentina,15,8,1909,1,-1,3,40,1,1,Argentina,Uruguay,9,1,0.67799,0.30068,1,winner,loser
Uruguay,Argentina,2,2,Copa Newton,Uruguay,19,9,1909,0,0,4,41,1,1,Uruguay,Argentina,9,0,0.08252,0.35677,1,draw,draw
Argentina,Uruguay,3,1,Copa Premio Honor Argentino,Argentina,10,10,1909,2,-2,4,42,1,1,Argentina,Uruguay,9,2,0.62124,0.98967,1,winner,loser
Belgium,Netherlands,3,2,Friendly,Belgium,13,3,1910,1,-1,5,43,1,1,Belgium,Netherlands,0,1,0.48635,0.27383,2,winner,loser
Wales,England,0,1,British Championship,Wales,14,3,1910,-1,1,1,44,0,1,Wales,England,0,1,0.33941,0.54379,2,loser,winner
France,Belgium,0,4,Friendly,France,3,4,1910,-4,4,4,45,0,1,France,Belgium,0,4,0.87944,0.51288,2,loser,winner
Switzerland,Germany,2,3,Friendly,Switzerland,3,4,1910,-1,1,5,46,0,1,Switzerland,Germany,0,1,0.46403,0.0186,2,loser,winner
Netherlands,Belgium,7,0,Friendly,Netherlands,10,4,1910,7,-7,7,47,1,1,Netherlands,Belgium,0,7,0.46759,0.99983,2,winner,loser
Netherlands,Germany,4,2,Friendly,Netherlands,24,4,1910,2,-2,6,48,1,1,Netherlands,Germany,0,2,0.5148,0.03713,2,winner,loser
Germany,Belgium,0,3,Friendly,Germany,16,5,1910,-3,3,3,49,1,1,Germany,Belgium,0,3,0.33764,0.80464,2,loser,winner
Argentina,Uruguay,4,1,Friendly,Argentina,12,6,1910,3,-3,5,50,1,1,Argentina,Uruguay,0,3,0.95692,0.1765,2,winner,loser
Uruguay,Argentina,3,1,Copa Lipton,Uruguay,15,8,1910,2,-2,4,51,1,1,Uruguay,Argentina,0,2,0.43194,0.86995,2,winner,loser
Germany,Netherlands,1,2,Friendly,Germany,16,10,1910,-1,1,3,52,1,1,Germany,Netherlands,0,1,0.09849,0.65734,2,loser,winner
Argentina,Uruguay,1,1,Copa Premio Honor Argentino,Argentina,13,11,1910,0,0,2,53,1,1,Argentina,Uruguay,0,0,0.86691,0.3122,2,draw,draw
Argentina,Uruguay,2,6,Copa Premio Honor Argentino,Argentina,27,11,1910,-4,4,8,54,1,1,Argentina,Uruguay,0,4,0.18399,0.97656,2,loser,winner
England,Wales,3,0,British Championship,England,13,3,1911,3,-3,3,55,1,0,England,Wales,1,3,0.71792,0.08493,2,winner,loser
Belgium,Netherlands,1,5,Friendly,Belgium,19,3,1911,-4,4,6,56,1,1,Belgium,Netherlands,1,4,0.7103,0.06806,2,loser,winner
Germany,Switzerland,6,2,Friendly,Germany,26,3,1911,4,-4,8,57,1,0,Germany,Switzerland,1,4,0.9369,0.64427,2,winner,loser
Netherlands,Belgium,3,1,Friendly,Netherlands,2,4,1911,2,-2,4,58,1,1,Netherlands,Belgium,1,2,0.87005,0.21851,2,winner,loser
Belgium,Germany,2,1,Friendly,Belgium,23,4,1911,1,-1,3,59,1,1,Belgium,Germany,1,1,0.1138,0.2065,2,winner,loser
Switzerland,France,5,2,Friendly,Switzerland,23,4,1911,3,-3,7,60,0,0,Switzerland,France,1,3,0.33022,0.30438,2,winner,loser
Belgium,France,7,1,Friendly,Belgium,30,4,1911,6,-6,8,61,1,0,Belgium,France,1,6,1.80E-04,0.38251,2,winner,loser
Argentina,Uruguay,0,2,Copa Lipton,Argentina,15,8,1911,-2,2,2,62,1,1,Argentina,Uruguay,1,2,0.83843,0.26518,2,loser,winner
Uruguay,Argentina,2,3,Copa Newton,Uruguay,17,9,1911,-1,1,5,63,1,1,Uruguay,Argentina,1,1,0.13662,0.25993,2,loser,winner
Uruguay,Argentina,1,1,Copa Premio Honor Uruguayo,Uruguay,8,10,1911,0,0,2,64,1,1,Uruguay,Argentina,1,0,0.46026,0.93109,2,draw,draw
Argentina,Uruguay,2,0,Copa Premio Honor Argentino,Argentina,22,10,1911,2,-2,2,65,1,1,Argentina,Uruguay,1,2,0.94177,0.88046,2,winner,loser
Uruguay,Argentina,3,0,Copa Premio Honor Uruguayo,Uruguay,29,10,1911,3,-3,3,66,1,1,Uruguay,Argentina,1,3,0.76615,0.69561,2,winner,loser
France,Belgium,1,1,Friendly,France,28,1,1912,0,0,2,67,0,1,France,Belgium,2,0,0.24444,0.48622,2,draw,draw
France,Switzerland,4,1,Friendly,France,18,2,1912,3,-3,5,68,0,0,France,Switzerland,2,3,0.16104,0.07883,2,winner,loser
Belgium,Switzerland,9,2,Friendly,Belgium,20,2,1912,7,-7,11,69,1,0,Belgium,Switzerland,2,7,0.33053,0.6486,2,winner,loser
Belgium,Netherlands,1,2,Friendly,Belgium,10,3,1912,-1,1,3,70,1,1,Belgium,Netherlands,2,1,0.62944,0.23237,2,loser,winner
Wales,England,0,2,British Championship,Wales,11,3,1912,-2,2,2,71,0,1,Wales,England,2,2,0.11583,0.16345,2,loser,winner
Netherlands,Germany,5,5,Friendly,Netherlands,24,3,1912,0,0,10,72,1,1,Netherlands,Germany,2,0,0.18547,0.98378,2,draw,draw
Netherlands,Belgium,4,3,Friendly,Netherlands,28,4,1912,1,-1,7,73,1,1,Netherlands,Belgium,2,1,0.66232,0.79557,2,winner,loser
Switzerland,Germany,1,2,Friendly,Switzerland,5,5,1912,-1,1,3,74,0,1,Switzerland,Germany,2,1,0.02101,0.5537,2,loser,winner
Uruguay,Argentina,2,0,Copa Lipton,Uruguay,15,8,1912,2,-2,2,75,1,1,Uruguay,Argentina,2,2,0.34656,0.6477,2,winner,loser
Uruguay,Argentina,3,0,Copa Premio Honor Uruguayo,Uruguay,25,8,1912,3,-3,3,76,1,1,Uruguay,Argentina,2,3,0.12034,0.85177,2,winner,loser
Argentina,Uruguay,0,1,Copa Premio Honor Argentino,Argentina,22,9,1912,-1,1,1,77,1,1,Argentina,Uruguay,2,1,0.97386,0.74696,2,loser,winner
Argentina,Uruguay,3,3,Copa Newton,Argentina,6,10,1912,0,0,6,78,1,1,Argentina,Uruguay,2,0,0.16806,0.50965,2,draw,draw
Denmark,Germany,3,1,Friendly,Denmark,6,10,1912,2,-2,4,79,1,1,Denmark,Germany,2,2,0.50639,0.03732,2,winner,loser
Germany,Netherlands,2,3,Friendly,Germany,17,11,1912,-1,1,5,80,1,1,Germany,Netherlands,2,1,0.44556,0.04262,2,loser,winner
Uruguay,Argentina,1,3,Friendly,Uruguay,1,12,1912,-2,2,4,81,1,1,Uruguay,Argentina,2,2,0.51906,0.29107,2,loser,winner
Belgium,France,3,0,Friendly,Belgium,16,2,1913,3,-3,3,82,1,0,Belgium,France,3,3,0.21092,0.28908,2,winner,loser
Belgium,Netherlands,3,3,Friendly,Belgium,9,3,1913,0,0,6,83,1,1,Belgium,Netherlands,3,0,0.14093,0.32001,2,draw,draw
Switzerland,France,1,4,Friendly,Switzerland,9,3,1913,-3,3,5,84,0,0,Switzerland,France,3,3,0.251,0.01669,2,loser,winner
England,Wales,4,3,British Championship,England,17,3,1913,1,-1,7,85,1,0,England,Wales,3,1,0.29209,0.82578,2,winner,loser
Netherlands,Belgium,2,4,Friendly,Netherlands,20,4,1913,-2,2,6,86,1,1,Netherlands,Belgium,3,2,0.67346,0.80479,2,loser,winner
Switzerland,Belgium,1,2,Friendly,Switzerland,4,5,1913,-1,1,3,87,0,1,Switzerland,Belgium,3,1,0.04192,0.46218,2,loser,winner
Germany,Switzerland,1,2,Friendly,Germany,18,5,1913,-1,1,3,88,1,0,Germany,Switzerland,3,1,0.38463,0.37574,2,loser,winner
Argentina,Uruguay,1,1,Friendly,Argentina,15,6,1913,0,0,2,89,1,1,Argentina,Uruguay,3,0,0.24359,0.71956,2,draw,draw
Argentina,Uruguay,2,1,Friendly,Argentina,9,7,1913,1,-1,3,90,1,1,Argentina,Uruguay,3,1,0.77826,0.6284,2,winner,loser
Argentina,Uruguay,4,0,Copa Lipton,Argentina,15,8,1913,4,-4,4,91,1,1,Argentina,Uruguay,3,4,0.91142,0.26314,2,winner,loser
Argentina,Uruguay,2,0,Copa Premio Honor Argentino,Argentina,31,8,1913,2,-2,2,92,1,1,Argentina,Uruguay,3,2,0.91327,0.18085,2,winner,loser
Uruguay,Argentina,1,0,Copa Premio Honor Uruguayo,Uruguay,5,10,1913,1,-1,1,93,1,1,Uruguay,Argentina,3,1,0.64681,0.22041,2,winner,loser
Germany,Denmark,1,4,Friendly,Germany,26,10,1913,-3,3,5,94,1,1,Germany,Denmark,3,3,0.55899,0.41373,2,loser,winner
Uruguay,Argentina,1,0,Copa Newton,Uruguay,26,10,1913,1,-1,1,95,1,1,Uruguay,Argentina,3,1,0.03246,0.90426,2,winner,loser
Belgium,Switzerland,2,0,Friendly,Belgium,2,11,1913,2,-2,2,96,1,0,Belgium,Switzerland,3,2,0.60705,0.50049,2,winner,loser
Belgium,Germany,6,2,Friendly,Belgium,23,11,1913,4,-4,8,97,1,1,Belgium,Germany,3,4,0.21062,0.71508,2,winner,loser
France,Belgium,4,3,Friendly,France,25,1,1914,1,-1,7,98,0,1,France,Belgium,4,1,0.51034,0.99109,2,winner,loser
France,Switzerland,2,2,Friendly,France,8,3,1914,0,0,4,99,0,0,France,Switzerland,4,0,0.5092,0.94515,2,draw,draw
Belgium,Netherlands,2,4,Friendly,Belgium,15,3,1914,-2,2,6,100,1,1,Belgium,Netherlands,4,2,0.36754,0.5813,2,loser,winner
Wales,England,0,2,British Championship,Wales,16,3,1914,-2,2,2,101,0,1,Wales,England,4,2,0.47803,0.57159,2,loser,winner
Netherlands,Germany,4,4,Friendly,Netherlands,5,4,1914,0,0,8,102,1,1,Netherlands,Germany,4,0,0.56769,0.93875,2,draw,draw
Netherlands,Belgium,4,2,Friendly,Netherlands,26,4,1914,2,-2,6,103,1,1,Netherlands,Belgium,4,2,0.05455,0.64142,2,winner,loser
Denmark,Netherlands,4,3,Friendly,Denmark,17,5,1914,1,-1,7,104,1,1,Denmark,Netherlands,4,1,0.90335,0.19729,2,winner,loser
Uruguay,Argentina,3,2,Copa Premio Honor Uruguayo,Uruguay,30,8,1914,1,-1,5,105,1,1,Uruguay,Argentina,4,1,0.96531,0.88838,2,winner,loser
Argentina,Uruguay,2,1,Copa Premio Honor Argentino,Argentina,13,9,1914,1,-1,3,106,1,1,Argentina,Uruguay,4,1,0.0672,0.01423,2,winner,loser
Argentina,Brazil,3,0,Friendly,Argentina,20,9,1914,3,-3,3,107,1,0,Argentina,Brazil,4,3,0.77439,0.58337,2,winner,loser
Argentina,Brazil,0,1,Copa Roca,Argentina,27,9,1914,-1,1,1,108,1,0,Argentina,Brazil,4,1,0.3192,0.84313,2,loser,winner
Uruguay,Argentina,2,3,Copa Premio Honor Uruguayo,Uruguay,18,7,1915,-1,1,5,109,1,1,Uruguay,Argentina,5,1,0.41811,0.48898,2,loser,winner
Argentina,Uruguay,2,1,Copa Lipton,Argentina,15,8,1915,1,-1,3,110,1,1,Argentina,Uruguay,5,1,0.60053,0.12035,2,winner,loser
Uruguay,Argentina,2,0,Copa Newton,Uruguay,12,9,1915,2,-2,2,111,1,1,Uruguay,Argentina,5,2,0.56831,0.48011,2,winner,loser
Argentina,Brazil,1,1,Copa America,Argentina,10,7,1916,0,0,2,112,1,0,Argentina,Brazil,6,0,0.59056,0.04609,2,draw,draw
Brazil,Uruguay,1,2,Copa America,Argentina,12,7,1916,-1,1,3,113,0,1,Brazil,Uruguay,6,1,0.49182,0.96817,2,loser,winner
Argentina,Uruguay,0,0,Copa America,Argentina,17,7,1916,0,0,0,114,1,1,Argentina,Uruguay,6,0,0.57447,0.67061,2,draw,draw
Uruguay,Brazil,0,1,Friendly,Uruguay,18,7,1916,-1,1,1,115,1,0,Uruguay,Brazil,6,1,0.32455,0.56976,2,loser,winner
Argentina,Uruguay,3,1,Copa Newton,Argentina,15,8,1916,2,-2,4,116,1,1,Argentina,Uruguay,6,2,0.71602,0.3146,2,winner,loser
Uruguay,Argentina,1,2,Copa Lipton,Uruguay,15,8,1916,-1,1,3,117,1,1,Uruguay,Argentina,6,1,0.6694,0.18628,2,loser,winner
Argentina,Uruguay,7,2,Friendly,Argentina,1,10,1916,5,-5,9,118,1,1,Argentina,Uruguay,6,5,0.75886,0.17714,2,winner,loser
Uruguay,Argentina,0,1,Copa Premio Honor Uruguayo,Uruguay,1,10,1916,-1,1,1,119,1,1,Uruguay,Argentina,6,1,0.27897,0.47313,2,loser,winner
Uruguay,Argentina,3,1,Friendly,Uruguay,29,10,1916,2,-2,4,120,1,1,Uruguay,Argentina,6,2,0.76657,0.22191,2,winner,loser
Uruguay,Argentina,0,2,Copa Premio Honor Uruguayo,Uruguay,18,7,1917,-2,2,2,121,1,1,Uruguay,Argentina,7,2,0.13827,0.51536,2,loser,winner
Argentina,Uruguay,1,0,Copa Lipton,Argentina,15,8,1917,1,-1,1,122,1,1,Argentina,Uruguay,7,1,0.39758,0.92975,2,winner,loser
Uruguay,Argentina,1,0,Copa Newton,Uruguay,2,9,1917,1,-1,1,123,1,1,Uruguay,Argentina,7,1,0.80742,0.85168,2,winner,loser
Argentina,Brazil,4,2,Copa America,Uruguay,3,10,1917,2,-2,6,124,1,0,Argentina,Brazil,7,2,0.41585,0.46398,2,winner,loser
Uruguay,Brazil,4,0,Copa America,Uruguay,7,10,1917,4,-4,4,125,1,0,Uruguay,Brazil,7,4,0.17605,0.42692,2,winner,loser
Uruguay,Argentina,1,0,Copa America,Uruguay,14,10,1917,1,-1,1,126,1,1,Uruguay,Argentina,7,1,0.18748,0.35901,2,winner,loser
Uruguay,Brazil,3,1,Friendly,Uruguay,16,10,1917,2,-2,4,127,1,0,Uruguay,Brazil,7,2,0.79042,0.34813,2,winner,loser
Uruguay,Argentina,1,1,Copa Premio Honor Uruguayo,Uruguay,18,7,1918,0,0,2,128,1,1,Uruguay,Argentina,8,0,0.70796,0.7532,2,draw,draw
Uruguay,Argentina,3,1,Copa Premio Honor Uruguayo,Uruguay,28,7,1918,2,-2,4,129,1,1,Uruguay,Argentina,8,2,0.74155,0.38894,2,winner,loser
Argentina,Uruguay,0,0,Copa Premio Honor Argentino,Argentina,15,8,1918,0,0,0,130,1,1,Argentina,Uruguay,8,0,0.18941,0.18397,2,draw,draw
Argentina,Uruguay,2,1,Copa Premio Honor Argentino,Argentina,25,8,1918,1,-1,3,131,1,1,Argentina,Uruguay,8,1,0.88719,0.02038,2,winner,loser
Uruguay,Argentina,1,1,Copa Lipton,Uruguay,20,9,1918,0,0,2,132,1,1,Uruguay,Argentina,8,0,0.14906,0.89805,2,draw,draw
Argentina,Uruguay,2,0,Copa Newton,Argentina,29,9,1918,2,-2,2,133,1,1,Argentina,Uruguay,8,2,0.93688,0.36918,2,winner,loser
Belgium,France,2,2,Friendly,Belgium,9,3,1919,0,0,4,134,1,0,Belgium,France,9,0,0.19597,0.28539,2,draw,draw
Argentina,Uruguay,2,3,Copa America,Brazil,13,5,1919,-1,1,5,135,1,1,Argentina,Uruguay,9,1,0.91535,0.24419,2,loser,winner
Brazil,Argentina,3,1,Copa America,Brazil,18,5,1919,2,-2,4,136,0,1,Brazil,Argentina,9,2,0.45707,0.93034,2,winner,loser
Brazil,Uruguay,2,2,Copa America,Brazil,26,5,1919,0,0,4,137,0,1,Brazil,Uruguay,9,0,0.15692,0.92063,2,draw,draw
Brazil,Uruguay,1,0,Copa America,Brazil,29,5,1919,1,-1,1,138,0,1,Brazil,Uruguay,9,1,0.78532,0.43297,2,winner,loser
Brazil,Argentina,3,3,Friendly,Brazil,1,6,1919,0,0,6,139,0,1,Brazil,Argentina,9,0,0.28445,0.41472,2,draw,draw
Uruguay,Argentina,4,1,Copa Premio Honor Uruguayo,Uruguay,18,7,1919,3,-3,5,140,1,1,Uruguay,Argentina,9,3,0.99873,0.53669,2,winner,loser
Uruguay,Argentina,2,1,Copa Newton,Uruguay,24,8,1919,1,-1,3,141,1,1,Uruguay,Argentina,9,1,0.21724,0.91448,2,winner,loser
Argentina,Uruguay,1,2,Copa Lipton,Argentina,7,9,1919,-1,1,3,142,1,1,Argentina,Uruguay,9,1,0.32016,0.71273,2,loser,winner
Argentina,Uruguay,6,1,Copa Premio Honor Argentino,Argentina,19,10,1919,5,-5,7,143,1,1,Argentina,Uruguay,9,5,0.55013,0.08505,2,winner,loser
Uruguay,Argentina,4,2,Friendly,Uruguay,7,12,1919,2,-2,6,144,1,1,Uruguay,Argentina,9,2,0.45405,0.72648,2,winner,loser
Switzerland,France,0,2,Friendly,Switzerland,29,2,1920,-2,2,2,145,0,0,Switzerland,France,0,2,0.33392,0.99979,3,loser,winner
England,Wales,1,2,British Championship,England,15,3,1920,-1,1,3,146,1,0,England,Wales,0,1,0.98643,0.2819,3,loser,winner
France,Belgium,2,1,Friendly,France,28,3,1920,1,-1,3,147,0,1,France,Belgium,0,1,0.14917,0.01072,3,winner,loser
Netherlands,Denmark,2,0,Friendly,Netherlands,5,4,1920,2,-2,2,148,1,1,Netherlands,Denmark,0,2,0.33603,0.51628,3,winner,loser
Switzerland,Netherlands,2,1,Friendly,Switzerland,16,5,1920,1,-1,3,149,0,1,Switzerland,Netherlands,0,1,0.20714,0.14689,3,winner,loser
Switzerland,Germany,4,1,Friendly,Switzerland,27,6,1920,3,-3,5,150,0,1,Switzerland,Germany,0,3,0.39572,0.00894,3,winner,loser
Uruguay,Argentina,2,0,Copa Premio Honor Uruguayo,Uruguay,18,7,1920,2,-2,2,151,1,1,Uruguay,Argentina,0,2,0.49071,0.72098,3,winner,loser
Argentina,Uruguay,1,3,Copa Newton,Argentina,25,7,1920,-2,2,4,152,1,1,Argentina,Uruguay,0,2,0.45369,0.25008,3,loser,winner
Argentina,Uruguay,1,0,Copa Premio Honor Argentino,Argentina,8,8,1920,1,-1,1,153,1,1,Argentina,Uruguay,0,1,0.20612,0.30172,3,winner,loser
Uruguay,Argentina,1,1,Copa America,Chile,12,9,1920,0,0,2,154,1,1,Uruguay,Argentina,0,0,0.23077,0.47286,3,draw,draw
Brazil,Uruguay,0,6,Copa America,Chile,18,9,1920,-6,6,6,155,0,1,Brazil,Uruguay,0,6,0.31444,0.41055,3,loser,winner
Argentina,Brazil,2,0,Copa America,Chile,25,9,1920,2,-2,2,156,1,0,Argentina,Brazil,0,2,0.3044,0.06958,3,winner,loser
Belgium,France,3,1,Friendly,Belgium,6,3,1921,2,-2,4,157,1,0,Belgium,France,1,2,0.84289,0.90062,3,winner,loser
Wales,England,0,0,British Championship,Wales,14,3,1921,0,0,0,158,0,1,Wales,England,1,0,0.78882,0.39984,3,draw,draw
Belgium,Netherlands,1,1,Friendly,Belgium,15,5,1921,0,0,2,159,1,1,Belgium,Netherlands,1,0,0.4988,0.8543,3,draw,draw
Belgium,England,0,2,Friendly,Belgium,21,5,1921,-2,2,2,160,1,1,Belgium,England,1,2,0.58802,0.68367,3,loser,winner
Denmark,Netherlands,1,1,Friendly,Denmark,12,6,1921,0,0,2,161,1,1,Denmark,Netherlands,1,0,0.89932,0.37914,3,draw,draw
Argentina,Brazil,1,0,Copa America,Argentina,2,10,1921,1,-1,1,162,1,0,Argentina,Brazil,1,1,0.49861,0.46696,3,winner,loser
Brazil,Uruguay,1,2,Copa America,Argentina,23,10,1921,-1,1,3,163,0,1,Brazil,Uruguay,1,1,0.14318,0.8436,3,loser,winner
Argentina,Uruguay,1,0,Copa America,Argentina,30,10,1921,1,-1,1,164,1,1,Argentina,Uruguay,1,1,0.30039,0.45565,3,winner,loser
France,Netherlands,0,5,Friendly,France,13,11,1921,-5,5,5,165,0,1,France,Netherlands,1,5,0.79207,0.14121,3,loser,winner
Spain,Portugal,3,1,Friendly,Spain,18,12,1921,2,-2,4,166,1,1,Spain,Portugal,1,2,0.65808,0.07614,3,winner,loser
France,Belgium,2,1,Friendly,France,15,1,1922,1,-1,3,167,0,1,France,Belgium,2,1,0.60816,0.69704,3,winner,loser
England,Wales,1,0,British Championship,England,13,3,1922,1,-1,1,168,1,0,England,Wales,2,1,0.39698,0.8369,3,winner,loser
Belgium,Netherlands,4,0,Friendly,Belgium,26,3,1922,4,-4,4,169,1,1,Belgium,Netherlands,2,4,0.15381,0.9531,3,winner,loser
Germany,Switzerland,2,2,Friendly,Germany,26,3,1922,0,0,4,170,1,0,Germany,Switzerland,2,0,0.8468,0.23196,3,draw,draw
Belgium,Denmark,0,0,Friendly,Belgium,15,4,1922,0,0,0,171,1,1,Belgium,Denmark,2,0,0.74548,0.79439,3,draw,draw
Netherlands,Denmark,2,0,Friendly,Netherlands,17,4,1922,2,-2,2,172,1,1,Netherlands,Denmark,2,2,0.56017,0.31576,3,winner,loser
France,Spain,0,4,Friendly,France,30,4,1922,-4,4,4,173,0,1,France,Spain,2,4,0.95273,0.87773,3,loser,winner
Netherlands,Belgium,1,2,Friendly,Netherlands,7,5,1922,-1,1,3,174,1,1,Netherlands,Belgium,2,1,0.71953,0.35741,3,loser,winner
Brazil,Uruguay,0,0,Copa America,Brazil,1,10,1922,0,0,0,175,0,1,Brazil,Uruguay,2,0,0.07453,0.3398,3,draw,draw
Argentina,Uruguay,0,1,Copa America,Brazil,8,10,1922,-1,1,1,176,1,1,Argentina,Uruguay,2,1,0.92368,0.17662,3,loser,winner
Brazil,Argentina,2,0,Copa America,Brazil,15,10,1922,2,-2,2,177,0,1,Brazil,Argentina,2,2,0.8569,0.19927,3,winner,loser
Brazil,Argentina,2,1,Copa Roca,Brazil,22,10,1922,1,-1,3,178,0,1,Brazil,Argentina,2,1,0.80657,0.94313,3,winner,loser
Uruguay,Argentina,1,0,Copa Lipton,Uruguay,12,11,1922,1,-1,1,179,1,1,Uruguay,Argentina,2,1,0.03862,0.26098,3,winner,loser
Switzerland,Netherlands,5,0,Friendly,Switzerland,19,11,1922,5,-5,5,180,0,1,Switzerland,Netherlands,2,5,0.4484,0.27022,3,winner,loser
Uruguay,Argentina,1,0,Copa Premio Honor Uruguayo,Uruguay,10,12,1922,1,-1,1,181,1,1,Uruguay,Argentina,2,1,0.89274,0.20894,3,winner,loser
Argentina,Uruguay,2,2,Copa Newton,Argentina,17,12,1922,0,0,4,182,1,1,Argentina,Uruguay,2,0,0.30047,0.15549,3,draw,draw
Portugal,Spain,1,2,Friendly,Portugal,17,12,1922,-1,1,3,183,1,1,Portugal,Spain,2,1,0.56543,0.60579,3,loser,winner
Spain,France,3,0,Friendly,Spain,28,1,1923,3,-3,3,184,1,0,Spain,France,3,3,0.79837,0.31319,3,winner,loser
Belgium,Spain,1,0,Friendly,Belgium,4,2,1923,1,-1,1,185,1,1,Belgium,Spain,3,1,0.67807,0.08217,3,winner,loser
Belgium,France,4,1,Friendly,Belgium,25,2,1923,3,-3,5,186,1,0,Belgium,France,3,3,0.30548,0.98311,3,winner,loser
Wales,England,2,2,British Championship,Wales,5,3,1923,0,0,4,187,0,1,Wales,England,3,0,0.23378,0.60252,3,draw,draw
England,Belgium,6,1,Friendly,England,19,3,1923,5,-5,7,188,1,1,England,Belgium,3,5,0.00194,0.2735,3,winner,loser
Netherlands,France,8,1,Friendly,Netherlands,2,4,1923,7,-7,9,189,1,0,Netherlands,France,3,7,0.19898,0.73214,3,winner,loser
France,Switzerland,2,2,Friendly,France,22,4,1923,0,0,4,190,0,0,France,Switzerland,3,0,0.70855,0.22853,3,draw,draw
Netherlands,Belgium,1,1,Friendly,Netherlands,29,4,1923,0,0,2,191,1,1,Netherlands,Belgium,3,0,0.42764,0.65798,3,draw,draw
France,England,1,4,Friendly,France,10,5,1923,-3,3,5,192,0,1,France,England,3,3,0.31776,0.73945,3,loser,winner
Germany,Netherlands,0,0,Friendly,Germany,10,5,1923,0,0,0,193,1,1,Germany,Netherlands,3,0,0.379,0.68898,3,draw,draw
Switzerland,Germany,1,2,Friendly,Switzerland,3,6,1923,-1,1,3,194,0,1,Switzerland,Germany,3,1,0.56848,0.34404,3,loser,winner
Denmark,Switzerland,3,2,Friendly,Denmark,17,6,1923,1,-1,5,195,1,0,Denmark,Switzerland,3,1,0.99514,0.21068,3,winner,loser
Argentina,Uruguay,0,0,Copa Lipton,Argentina,24,6,1923,0,0,0,196,1,1,Argentina,Uruguay,3,0,0.26457,0.0861,3,draw,draw
Argentina,Uruguay,2,2,Friendly,Argentina,15,7,1923,0,0,4,197,1,1,Argentina,Uruguay,3,0,0.92492,0.92826,3,draw,draw
Uruguay,Argentina,2,2,Copa Premio Honor Uruguayo,Uruguay,22,7,1923,0,0,4,198,1,1,Uruguay,Argentina,3,0,0.50268,0.46574,3,draw,draw
Uruguay,Argentina,0,2,Copa Premio Honor Uruguayo,Uruguay,30,9,1923,-2,2,2,199,1,1,Uruguay,Argentina,3,2,0.43638,0.18443,3,loser,winner
Belgium,England,2,2,Friendly,Belgium,1,11,1923,0,0,4,200,1,1,Belgium,England,3,0,0.4115,0.49051,3,draw,draw
Argentina,Brazil,2,1,Copa America,Uruguay,18,11,1923,1,-1,3,201,1,0,Argentina,Brazil,3,1,0.49681,0.05468,3,winner,loser
Netherlands,Switzerland,4,1,Friendly,Netherlands,25,11,1923,3,-3,5,202,1,0,Netherlands,Switzerland,3,3,0.23419,0.30552,3,winner,loser
Uruguay,Brazil,2,1,Copa America,Uruguay,25,11,1923,1,-1,3,203,1,0,Uruguay,Brazil,3,1,0.87164,0.49687,3,winner,loser
Argentina,Brazil,0,2,Friendly,Argentina,2,12,1923,-2,2,2,204,1,0,Argentina,Brazil,3,2,0.02861,0.1273,3,loser,winner
Uruguay,Argentina,2,0,Copa America,Uruguay,2,12,1923,2,-2,2,205,1,1,Uruguay,Argentina,3,2,0.25032,0.44933,3,winner,loser
Argentina,Brazil,2,0,Copa Roca,Argentina,9,12,1923,2,-2,2,206,1,0,Argentina,Brazil,3,2,0.79418,0.91374,3,winner,loser
Spain,Portugal,3,0,Friendly,Spain,16,12,1923,3,-3,3,207,1,1,Spain,Portugal,3,3,0.42971,0.26161,3,winner,loser
France,Belgium,2,0,Friendly,France,13,1,1924,2,-2,2,208,0,1,France,Belgium,4,2,0.5435,0.58936,3,winner,loser
England,Wales,1,2,British Championship,England,3,3,1924,-1,1,3,209,1,0,England,Wales,4,1,0.02092,0.78699,3,loser,winner
Netherlands,Belgium,1,1,Friendly,Netherlands,23,3,1924,0,0,2,210,1,1,Netherlands,Belgium,4,0,0.46125,0.26046,3,draw,draw
Switzerland,France,3,0,Friendly,Switzerland,23,3,1924,3,-3,3,211,0,0,Switzerland,France,4,3,0.92769,0.84156,3,winner,loser
Netherlands,Germany,0,1,Friendly,Netherlands,21,4,1924,-1,1,1,212,1,1,Netherlands,Germany,4,1,0.61757,0.60091,3,loser,winner
Switzerland,Denmark,2,0,Friendly,Switzerland,21,4,1924,2,-2,2,213,0,1,Switzerland,Denmark,4,2,0.10109,0.80901,3,winner,loser
Belgium,Netherlands,1,1,Friendly,Belgium,27,4,1924,0,0,2,214,1,1,Belgium,Netherlands,4,0,0.1354,0.51459,3,draw,draw
France,England,1,3,Friendly,France,17,5,1924,-2,2,4,215,0,1,France,England,4,2,0.85722,0.90036,3,loser,winner
Argentina,Uruguay,4,0,Copa Newton,Argentina,25,5,1924,4,-4,4,216,1,1,Argentina,Uruguay,4,4,0.17364,0.27981,3,winner,loser
Uruguay,Argentina,2,0,Copa Lipton,Uruguay,25,5,1924,2,-2,2,217,1,1,Uruguay,Argentina,4,2,0.86871,0.46917,3,winner,loser
Australia,Canada,3,2,Friendly,Australia,7,6,1924,1,-1,5,218,0,0,Australia,Canada,4,1,0.68237,0.53502,3,winner,loser
Poland,United States,2,3,Friendly,Poland,10,6,1924,-1,1,5,219,0,0,Poland,United_States,4,1,0.3345,0.10086,3,loser,winner
Australia,Canada,0,1,Friendly,Australia,14,6,1924,-1,1,1,220,0,0,Australia,Canada,4,1,0.14545,0.40701,3,loser,winner
Australia,Canada,4,1,Friendly,Australia,23,6,1924,3,-3,5,221,0,0,Australia,Canada,4,3,0.86432,0.74525,3,winner,loser
Australia,Canada,0,0,Friendly,Australia,28,6,1924,0,0,0,222,0,0,Australia,Canada,4,0,0.44874,0.39294,3,draw,draw
Australia,Canada,1,4,Friendly,Australia,12,7,1924,-3,3,5,223,0,0,Australia,Canada,4,3,0.73336,0.10001,3,loser,winner
Australia,Canada,1,0,Friendly,Australia,26,7,1924,1,-1,1,224,0,0,Australia,Canada,4,1,0.1054,0.0235,3,winner,loser
Uruguay,Argentina,1,1,Friendly,Uruguay,21,9,1924,0,0,2,225,1,1,Uruguay,Argentina,4,0,0.56036,0.79616,3,draw,draw
Argentina,Uruguay,2,1,Friendly,Argentina,2,10,1924,1,-1,3,226,1,1,Argentina,Uruguay,4,1,0.52794,0.54626,3,winner,loser
Denmark,Belgium,2,1,Friendly,Denmark,5,10,1924,1,-1,3,227,1,1,Denmark,Belgium,4,1,0.63524,0.16762,3,winner,loser
Uruguay,Argentina,0,0,Copa America,Uruguay,2,11,1924,0,0,0,228,1,1,Uruguay,Argentina,4,0,0.27117,0.61694,3,draw,draw
Belgium,France,3,0,Friendly,Belgium,11,11,1924,3,-3,3,229,1,0,Belgium,France,4,3,0.55652,0.14851,3,winner,loser
England,Belgium,4,0,Friendly,England,8,12,1924,4,-4,4,230,1,1,England,Belgium,4,4,0.29766,0.58357,3,winner,loser
Germany,Switzerland,1,1,Friendly,Germany,14,12,1924,0,0,2,231,1,0,Germany,Switzerland,4,0,0.99434,0.91223,3,draw,draw
Wales,England,1,2,British Championship,Wales,28,2,1925,-1,1,3,232,0,1,Wales,England,5,1,0.15876,0.55413,3,loser,winner
Belgium,Netherlands,0,1,Friendly,Belgium,15,3,1925,-1,1,1,233,1,1,Belgium,Netherlands,5,1,0.80527,0.11137,3,loser,winner
Netherlands,Germany,2,1,Friendly,Netherlands,29,3,1925,1,-1,3,234,1,1,Netherlands,Germany,5,1,0.30488,0.97434,3,winner,loser
Switzerland,Netherlands,4,1,Friendly,Switzerland,19,4,1925,3,-3,5,235,0,1,Switzerland,Netherlands,5,3,0.46877,0.19135,3,winner,loser
Netherlands,Belgium,5,0,Friendly,Netherlands,3,5,1925,5,-5,5,236,1,1,Netherlands,Belgium,5,5,0.13496,0.50874,3,winner,loser
France,England,2,3,Friendly,France,21,5,1925,-1,1,5,237,0,1,France,England,5,1,0.36607,0.12007,3,loser,winner
Switzerland,Belgium,0,0,Friendly,Switzerland,24,5,1925,0,0,0,238,0,1,Switzerland,Belgium,5,0,0.84139,0.51521,3,draw,draw
Switzerland,Spain,0,3,Friendly,Switzerland,1,6,1925,-3,3,3,239,0,1,Switzerland,Spain,5,3,0.71759,0.20034,3,loser,winner
Canada,United States,1,0,Friendly,Canada,27,6,1925,1,-1,1,240,0,0,Canada,United_States,5,1,0.27613,0.36351,3,winner,loser
Netherlands,Denmark,4,2,Friendly,Netherlands,25,10,1925,2,-2,6,241,1,1,Netherlands,Denmark,5,2,0.33241,0.18024,3,winner,loser
Switzerland,Germany,0,4,Friendly,Switzerland,25,10,1925,-4,4,4,242,0,1,Switzerland,Germany,5,4,0.76527,0.59775,3,loser,winner
United States,Canada,6,1,Friendly,United States,8,11,1925,5,-5,7,243,0,0,United_States,Canada,5,5,0.16143,0.93722,3,winner,loser
Argentina,Brazil,4,1,Copa America,Argentina,13,12,1925,3,-3,5,244,1,0,Argentina,Brazil,5,3,0.56719,0.348,3,winner,loser
Argentina,Brazil,2,2,Copa America,Argentina,25,12,1925,0,0,4,245,1,0,Argentina,Brazil,5,0,0.66802,0.83793,3,draw,draw
England,Wales,1,3,British Championship,England,1,3,1926,-2,2,4,246,1,0,England,Wales,6,2,0.795,0.09179,3,loser,winner
Belgium,Netherlands,1,1,Friendly,Belgium,14,3,1926,0,0,2,247,1,1,Belgium,Netherlands,6,0,0.78991,0.16428,3,draw,draw
Netherlands,Switzerland,5,0,Friendly,Netherlands,28,3,1926,5,-5,5,248,1,0,Netherlands,Switzerland,6,5,0.71217,0.6333,3,winner,loser
France,Belgium,4,3,Friendly,France,11,4,1926,1,-1,7,249,0,1,France,Belgium,6,1,0.77705,0.64079,3,winner,loser
France,Portugal,4,2,Friendly,France,18,4,1926,2,-2,6,250,0,1,France,Portugal,6,2,0.45136,0.00151,3,winner,loser
Germany,Netherlands,4,2,Friendly,Germany,18,4,1926,2,-2,6,251,1,1,Germany,Netherlands,6,2,0.35256,0.78033,3,winner,loser
France,Switzerland,1,0,Friendly,France,25,4,1926,1,-1,1,252,0,0,France,Switzerland,6,1,0.35491,0.06817,3,winner,loser
Netherlands,Belgium,1,5,Friendly,Netherlands,2,5,1926,-4,4,6,253,1,1,Netherlands,Belgium,6,4,0.51182,0.479,3,loser,winner
Belgium,England,3,5,Friendly,Belgium,24,5,1926,-2,2,8,254,1,1,Belgium,England,6,2,0.25755,0.23439,3,loser,winner
Denmark,Netherlands,4,1,Friendly,Denmark,13,6,1926,3,-3,5,255,1,1,Denmark,Netherlands,6,3,0.14608,0.57152,3,winner,loser
Belgium,France,2,2,Friendly,Belgium,20,6,1926,0,0,4,256,1,0,Belgium,France,6,0,0.58539,0.25075,3,draw,draw
Argentina,Uruguay,0,2,Copa America,Chile,24,10,1926,-2,2,2,257,1,1,Argentina,Uruguay,6,2,0.25747,0.73245,3,loser,winner
Netherlands,Germany,2,3,Friendly,Netherlands,31,10,1926,-1,1,5,258,1,1,Netherlands,Germany,6,1,0.41365,0.17178,3,loser,winner
United States,Canada,6,2,Friendly,United States,6,11,1926,4,-4,8,259,0,0,United_States,Canada,6,4,0.77547,0.1688,3,winner,loser
Germany,Switzerland,2,3,Friendly,Germany,12,12,1926,-1,1,5,260,1,0,Germany,Switzerland,6,1,0.85553,0.29521,3,loser,winner
Wales,England,3,3,British Championship,Wales,12,2,1927,0,0,6,261,0,1,Wales,England,7,0,0.65447,0.84325,3,draw,draw
Belgium,Netherlands,2,0,Friendly,Belgium,13,3,1927,2,-2,2,262,1,1,Belgium,Netherlands,7,2,0.36985,0.19967,3,winner,loser
Portugal,France,4,0,Friendly,Portugal,16,3,1927,4,-4,4,263,1,0,Portugal,France,7,4,0.0952,0.90404,3,winner,loser
Spain,Switzerland,1,0,Friendly,Spain,17,4,1927,1,-1,1,264,1,0,Spain,Switzerland,7,1,0.52388,0.8284,3,winner,loser
Netherlands,Belgium,3,2,Friendly,Netherlands,1,5,1927,1,-1,5,265,1,1,Netherlands,Belgium,7,1,0.0457,0.13675,3,winner,loser
Belgium,England,1,9,Friendly,Belgium,11,5,1927,-8,8,10,266,1,1,Belgium,England,7,8,0.95272,0.4824,3,loser,winner
France,Spain,1,4,Friendly,France,22,5,1927,-3,3,5,267,0,1,France,Spain,7,3,0.7012,0.09667,3,loser,winner
France,England,0,6,Friendly,France,26,5,1927,-6,6,6,268,0,1,France,England,7,6,0.78089,0.57687,3,loser,winner
Denmark,Netherlands,1,1,Friendly,Denmark,12,6,1927,0,0,2,269,1,1,Denmark,Netherlands,7,0,0.88403,0.28708,3,draw,draw
Uruguay,Argentina,0,1,Copa Newton,Uruguay,14,7,1927,-1,1,1,270,1,1,Uruguay,Argentina,7,1,0.43239,0.14593,3,loser,winner
Argentina,Uruguay,0,1,Copa Lipton,Argentina,30,8,1927,-1,1,1,271,1,1,Argentina,Uruguay,7,1,0.85575,0.19002,3,loser,winner
Denmark,Germany,3,1,Friendly,Denmark,2,10,1927,2,-2,4,272,1,1,Denmark,Germany,7,2,0.85785,0.49479,3,winner,loser
Argentina,Uruguay,3,2,Copa America,Peru,20,11,1927,1,-1,5,273,1,1,Argentina,Uruguay,7,1,0.05922,0.79921,3,winner,loser
Germany,Netherlands,2,2,Friendly,Germany,20,11,1927,0,0,4,274,1,1,Germany,Netherlands,7,0,0.42024,0.32335,3,draw,draw
England,Wales,1,2,British Championship,England,28,11,1927,-1,1,3,275,1,0,England,Wales,7,1,0.51543,0.32028,3,loser,winner
Portugal,Spain,2,2,Friendly,Portugal,8,1,1928,0,0,4,276,1,1,Portugal,Spain,8,0,0.27284,0.08498,3,draw,draw
Netherlands,Belgium,1,1,Friendly,Netherlands,11,3,1928,0,0,2,277,1,1,Netherlands,Belgium,8,0,0.17009,0.01664,3,draw,draw
Switzerland,France,4,3,Friendly,Switzerland,11,3,1928,1,-1,7,278,0,0,Switzerland,France,8,1,0.51458,0.8665,3,winner,loser
Belgium,Netherlands,1,0,Friendly,Belgium,1,4,1928,1,-1,1,279,1,1,Belgium,Netherlands,8,1,0.10434,0.88882,3,winner,loser
Portugal,Argentina,0,0,Friendly,Portugal,1,4,1928,0,0,0,280,1,1,Portugal,Argentina,8,0,0.99198,0.77193,3,draw,draw
France,Belgium,2,3,Friendly,France,15,4,1928,-1,1,5,281,0,1,France,Belgium,8,1,0.46477,0.34375,3,loser,winner
Switzerland,Germany,2,3,Friendly,Switzerland,15,4,1928,-1,1,5,282,0,1,Switzerland,Germany,8,1,0.91635,0.08694,3,loser,winner
Netherlands,Denmark,2,0,Friendly,Netherlands,22,4,1928,2,-2,2,283,1,1,Netherlands,Denmark,8,2,0.74362,0.63566,3,winner,loser
France,Portugal,1,1,Friendly,France,29,4,1928,0,0,2,284,0,1,France,Portugal,8,0,0.19319,0.53557,3,draw,draw
Switzerland,Netherlands,2,1,Friendly,Switzerland,6,5,1928,1,-1,3,285,0,1,Switzerland,Netherlands,8,1,0.87318,0.84369,3,winner,loser
France,England,1,5,Friendly,France,17,5,1928,-4,4,6,286,0,1,France,England,8,4,0.08212,0.56487,3,loser,winner
Belgium,England,1,3,Friendly,Belgium,19,5,1928,-2,2,4,287,1,1,Belgium,England,8,2,0.76904,0.59074,3,loser,winner
Poland,United States,3,3,Friendly,Poland,10,6,1928,0,0,6,288,0,0,Poland,United_States,8,0,0.88867,0.0813,3,draw,draw
Argentina,Uruguay,1,0,Copa Newton,Argentina,30,8,1928,1,-1,1,289,1,1,Argentina,Uruguay,8,1,0.89521,0.91673,3,winner,loser
Germany,Denmark,2,1,Friendly,Germany,16,9,1928,1,-1,3,290,1,1,Germany,Denmark,8,1,0.44368,0.026,3,winner,loser
Uruguay,Argentina,2,2,Copa Lipton,Uruguay,21,9,1928,0,0,4,291,1,1,Uruguay,Argentina,8,0,0.69689,0.36106,3,draw,draw
Netherlands,Belgium,1,1,Friendly,Netherlands,4,11,1928,0,0,2,292,1,1,Netherlands,Belgium,8,0,0.91911,0.54027,3,draw,draw
Wales,England,2,3,British Championship,Wales,17,11,1928,-1,1,5,293,0,1,Wales,England,8,1,0.70782,0.22391,3,loser,winner
Germany,Switzerland,7,1,Friendly,Germany,10,2,1929,6,-6,8,294,1,0,Germany,Switzerland,9,6,0.87446,0.7516,3,winner,loser
Netherlands,Switzerland,3,2,Friendly,Netherlands,17,3,1929,1,-1,5,295,1,0,Netherlands,Switzerland,9,1,0.96297,0.45102,3,winner,loser
Spain,Portugal,5,0,Friendly,Spain,17,3,1929,5,-5,5,296,1,1,Spain,Portugal,9,5,0.90621,0.1516,3,winner,loser
France,Portugal,2,0,Friendly,France,24,3,1929,2,-2,2,297,0,1,France,Portugal,9,2,0.61067,0.44874,3,winner,loser
Spain,France,8,1,Friendly,Spain,14,4,1929,7,-7,9,298,1,0,Spain,France,9,7,0.34448,0.29884,3,winner,loser
Belgium,Netherlands,3,1,Friendly,Belgium,5,5,1929,2,-2,4,299,1,1,Belgium,Netherlands,9,2,0.77989,0.57692,3,winner,loser
France,England,1,4,Friendly,France,9,5,1929,-3,3,5,300,0,1,France,England,9,3,0.55195,0.25331,3,loser,winner
Belgium,England,1,5,Friendly,Belgium,11,5,1929,-4,4,6,301,1,1,Belgium,England,9,4,0.02838,0.66328,3,loser,winner
Spain,England,4,3,Friendly,Spain,15,5,1929,1,-1,7,302,1,1,Spain,England,9,1,0.21609,0.09899,3,winner,loser
Belgium,France,4,1,Friendly,Belgium,26,5,1929,3,-3,5,303,1,0,Belgium,France,9,3,0.24151,0.03377,3,winner,loser
Argentina,Uruguay,2,0,Friendly,Argentina,16,6,1929,2,-2,2,304,1,1,Argentina,Uruguay,9,2,0.42167,0.56732,3,winner,loser
Uruguay,Argentina,1,1,Friendly,Uruguay,16,6,1929,0,0,2,305,1,1,Uruguay,Argentina,9,0,0.62132,0.998,3,draw,draw
Uruguay,Argentina,2,1,Copa Newton,Uruguay,20,9,1929,1,-1,3,306,1,1,Uruguay,Argentina,9,1,0.79979,0.49504,3,winner,loser
Argentina,Uruguay,0,0,Copa Lipton,Argentina,28,9,1929,0,0,0,307,1,1,Argentina,Uruguay,9,0,0.86507,0.96376,3,draw,draw
Argentina,Uruguay,2,0,Copa America,Argentina,17,11,1929,2,-2,2,308,1,1,Argentina,Uruguay,9,2,0.94968,0.75816,3,winner,loser
England,Wales,6,0,British Championship,England,20,11,1929,6,-6,6,309,1,0,England,Wales,9,6,0.40926,0.08579,3,winner,loser
Portugal,France,2,0,Friendly,Portugal,23,2,1930,2,-2,2,310,1,0,Portugal,France,0,2,0.59978,0.87298,4,winner,loser
France,Switzerland,3,3,Friendly,France,23,3,1930,0,0,6,311,0,0,France,Switzerland,0,0,0.15457,0.88558,4,draw,draw
France,Belgium,1,6,Friendly,France,13,4,1930,-5,5,7,312,0,1,France,Belgium,0,5,0.50203,0.66976,4,loser,winner
Netherlands,Belgium,2,2,Friendly,Netherlands,4,5,1930,0,0,4,313,1,1,Netherlands,Belgium,0,0,0.35793,0.18816,4,draw,draw
Switzerland,Germany,0,5,Friendly,Switzerland,4,5,1930,-5,5,5,314,0,1,Switzerland,Germany,0,5,0.21025,0.82582,4,loser,winner
Germany,England,3,3,Friendly,Germany,10,5,1930,0,0,6,315,1,1,Germany,England,0,0,0.75947,0.17493,4,draw,draw
Belgium,Netherlands,3,1,Friendly,Belgium,18,5,1930,2,-2,4,316,1,1,Belgium,Netherlands,0,2,0.17125,0.61233,4,winner,loser
Argentina,Uruguay,1,1,Copa Newton,Argentina,25,5,1930,0,0,2,317,1,1,Argentina,Uruguay,0,0,0.69401,0.37743,4,draw,draw
Belgium,France,1,2,Friendly,Belgium,25,5,1930,-1,1,3,318,1,0,Belgium,France,0,1,0.26971,0.7096,4,loser,winner
Belgium,Portugal,2,1,Friendly,Belgium,8,6,1930,1,-1,3,319,1,1,Belgium,Portugal,0,1,0.37424,0.26008,4,winner,loser
Belgium,United States,0,3,FIFA World Cup,Uruguay,13,7,1930,-3,3,3,320,1,0,Belgium,United_States,0,3,0.02717,0.34256,4,loser,winner
France,Mexico,4,1,FIFA World Cup,Uruguay,13,7,1930,3,-3,5,321,0,1,France,Mexico,0,3,0.2906,0.62752,4,winner,loser
Argentina,France,1,0,FIFA World Cup,Uruguay,15,7,1930,1,-1,1,322,1,0,Argentina,France,0,1,0.88038,0.89945,4,winner,loser
Argentina,Mexico,6,3,FIFA World Cup,Uruguay,19,7,1930,3,-3,9,323,1,1,Argentina,Mexico,0,3,0.44844,0.76381,4,winner,loser
Argentina,United States,6,1,FIFA World Cup,Uruguay,26,7,1930,5,-5,7,324,1,0,Argentina,United_States,0,5,0.31892,0.65172,4,winner,loser
Uruguay,Argentina,4,2,FIFA World Cup,Uruguay,30,7,1930,2,-2,6,325,1,1,Uruguay,Argentina,0,2,0.49117,0.0685,4,winner,loser
Brazil,France,3,2,Friendly,Brazil,1,8,1930,1,-1,5,326,0,0,Brazil,France,0,1,0.46353,0.37706,4,winner,loser
Brazil,United States,4,3,Friendly,Brazil,17,8,1930,1,-1,7,327,0,0,Brazil,United_States,0,1,0.97367,0.74918,4,winner,loser
Denmark,Germany,6,3,Friendly,Denmark,7,9,1930,3,-3,9,328,1,1,Denmark,Germany,0,3,0.3746,0.58209,4,winner,loser
Switzerland,Netherlands,6,3,Friendly,Switzerland,2,11,1930,3,-3,9,329,0,1,Switzerland,Netherlands,0,3,0.09538,0.65721,4,winner,loser
Wales,England,0,4,British Championship,Wales,22,11,1930,-4,4,4,330,0,1,Wales,England,0,4,0.17912,0.36354,4,loser,winner
Portugal,Spain,0,1,Friendly,Portugal,30,11,1930,-1,1,1,331,1,1,Portugal,Spain,0,1,0.49426,0.05079,4,loser,winner
France,Belgium,2,2,Friendly,France,7,12,1930,0,0,4,332,0,1,France,Belgium,0,0,0.4569,0.29499,4,draw,draw
France,Germany,1,0,Friendly,France,15,3,1931,1,-1,1,333,0,1,France,Germany,1,1,0.32473,0.60976,4,winner,loser
Netherlands,Belgium,3,2,Friendly,Netherlands,29,3,1931,1,-1,5,334,1,1,Netherlands,Belgium,1,1,0.42272,0.85742,4,winner,loser
Netherlands,Germany,1,1,Friendly,Netherlands,26,4,1931,0,0,2,335,1,1,Netherlands,Germany,1,0,0.88176,0.76691,4,draw,draw
Belgium,Netherlands,4,2,Friendly,Belgium,3,5,1931,2,-2,6,336,1,1,Belgium,Netherlands,1,2,0.7622,0.30891,4,winner,loser
France,England,5,2,Friendly,France,14,5,1931,3,-3,7,337,0,1,France,England,1,3,0.65587,0.96113,4,winner,loser
Belgium,England,1,4,Friendly,Belgium,16,5,1931,-3,3,5,338,1,1,Belgium,England,1,3,0.72211,0.18569,4,loser,winner
Portugal,Belgium,3,2,Friendly,Portugal,31,5,1931,1,-1,5,339,1,1,Portugal,Belgium,1,1,0.20282,0.04045,4,winner,loser
Denmark,Netherlands,0,2,Friendly,Denmark,14,6,1931,-2,2,2,340,1,1,Denmark,Netherlands,1,2,0.68311,0.69989,4,loser,winner
Brazil,Uruguay,2,0,Copa Rio Branco,Brazil,6,9,1931,2,-2,2,341,0,1,Brazil,Uruguay,1,2,0.02969,0.10263,4,winner,loser
Germany,Denmark,4,2,Friendly,Germany,27,9,1931,2,-2,6,342,1,1,Germany,Denmark,1,2,0.33326,0.82698,4,winner,loser
Belgium,Poland,2,1,Friendly,Belgium,11,10,1931,1,-1,3,343,1,0,Belgium,Poland,1,1,0.5494,0.12425,4,winner,loser
England,Wales,3,1,British Championship,England,18,11,1931,2,-2,4,344,1,0,England,Wales,1,2,0.15414,0.26124,4,winner,loser
France,Netherlands,3,4,Friendly,France,29,11,1931,-1,1,7,345,0,1,France,Netherlands,1,1,0.93509,0.48867,4,loser,winner
Belgium,Switzerland,2,1,Friendly,Belgium,6,12,1931,1,-1,3,346,1,0,Belgium,Switzerland,1,1,0.80972,0.72432,4,winner,loser
England,Spain,7,1,Friendly,England,9,12,1931,6,-6,8,347,1,1,England,Spain,1,6,0.34456,0.25543,4,winner,loser
Germany,Switzerland,2,0,Friendly,Germany,6,3,1932,2,-2,2,348,1,0,Germany,Switzerland,2,2,0.7555,0.98637,4,winner,loser
Belgium,Netherlands,1,4,Friendly,Belgium,20,3,1932,-3,3,5,349,1,1,Belgium,Netherlands,2,3,0.03524,0.74155,4,loser,winner
Switzerland,France,3,3,Friendly,Switzerland,20,3,1932,0,0,6,350,0,0,Switzerland,France,2,0,0.43756,0.84315,4,draw,draw
Netherlands,Belgium,2,1,Friendly,Netherlands,17,4,1932,1,-1,3,351,1,1,Netherlands,Belgium,2,1,0.40134,0.88739,4,winner,loser
Belgium,France,5,2,Friendly,Belgium,1,5,1932,3,-3,7,352,1,0,Belgium,France,2,3,0.91653,0.35198,4,winner,loser
Argentina,Uruguay,2,0,Friendly,Argentina,15,5,1932,2,-2,2,353,1,1,Argentina,Uruguay,2,2,0.64627,0.63495,4,winner,loser
Uruguay,Argentina,1,0,Friendly,Uruguay,18,5,1932,1,-1,1,354,1,1,Uruguay,Argentina,2,1,0.26175,0.0675,4,winner,loser
Denmark,Belgium,3,4,Friendly,Denmark,5,6,1932,-1,1,7,355,1,1,Denmark,Belgium,2,1,0.20683,0.45015,4,loser,winner
Wales,England,0,0,British Championship,Wales,16,11,1932,0,0,0,356,0,1,Wales,England,2,0,0.51366,0.44289,4,draw,draw
Germany,Netherlands,0,2,Friendly,Germany,4,12,1932,-2,2,2,357,1,1,Germany,Netherlands,2,2,0.25374,0.20758,4,loser,winner
Uruguay,Brazil,1,2,Copa Rio Branco,Uruguay,4,12,1932,-1,1,3,358,1,0,Uruguay,Brazil,2,1,0.68853,0.94275,4,loser,winner
Uruguay,Argentina,2,1,Friendly,Uruguay,21,1,1933,1,-1,3,359,1,1,Uruguay,Argentina,3,1,0.13606,0.90632,4,winner,loser
Netherlands,Switzerland,0,2,Friendly,Netherlands,22,1,1933,-2,2,2,360,1,0,Netherlands,Switzerland,3,2,0.02072,0.86179,4,loser,winner
Argentina,Uruguay,4,1,Friendly,Argentina,5,2,1933,3,-3,5,361,1,1,Argentina,Uruguay,3,3,0.64029,0.99326,4,winner,loser
Switzerland,Belgium,3,3,Friendly,Switzerland,12,3,1933,0,0,6,362,0,1,Switzerland,Belgium,3,0,0.63934,0.29002,4,draw,draw
Germany,France,3,3,Friendly,Germany,19,3,1933,0,0,6,363,1,0,Germany,France,3,0,0.97285,0.2414,4,draw,draw
France,Belgium,3,0,Friendly,France,26,3,1933,3,-3,3,364,0,1,France,Belgium,3,3,0.90863,0.94147,4,winner,loser
Spain,Portugal,3,0,Friendly,Spain,2,4,1933,3,-3,3,365,1,1,Spain,Portugal,3,3,0.79991,0.21861,4,winner,loser
Belgium,Netherlands,1,3,Friendly,Belgium,9,4,1933,-2,2,4,366,1,1,Belgium,Netherlands,3,2,0.36152,0.89804,4,loser,winner
France,Spain,1,0,Friendly,France,23,4,1933,1,-1,1,367,0,1,France,Spain,3,1,0.10238,0.26111,4,winner,loser
Netherlands,Belgium,1,2,Friendly,Netherlands,7,5,1933,-1,1,3,368,1,1,Netherlands,Belgium,3,1,0.08801,0.46408,4,loser,winner
Switzerland,England,0,4,Friendly,Switzerland,20,5,1933,-4,4,4,369,0,1,Switzerland,England,3,4,0.78043,0.74454,4,loser,winner
France,Wales,1,1,Friendly,France,25,5,1933,0,0,2,370,0,0,France,Wales,3,0,0.32003,0.95968,4,draw,draw
Poland,Belgium,0,1,Friendly,Poland,4,6,1933,-1,1,1,371,0,1,Poland,Belgium,3,1,0.87968,0.05052,4,loser,winner
Germany,Belgium,8,1,Friendly,Germany,22,10,1933,7,-7,9,372,1,1,Germany,Belgium,3,7,0.17043,0.14948,4,winner,loser
England,Wales,1,2,British Championship,England,15,11,1933,-1,1,3,373,1,0,England,Wales,3,1,0.97756,0.61051,4,loser,winner
Switzerland,Germany,0,2,Friendly,Switzerland,19,11,1933,-2,2,2,374,0,1,Switzerland,Germany,3,2,0.62835,0.70039,4,loser,winner
Belgium,Denmark,2,2,Friendly,Belgium,26,11,1933,0,0,4,375,1,1,Belgium,Denmark,3,0,0.42405,0.8176,4,draw,draw
Germany,Poland,1,0,Friendly,Germany,3,12,1933,1,-1,1,376,1,0,Germany,Poland,3,1,0.40688,0.33854,4,winner,loser
England,France,4,1,Friendly,England,6,12,1933,3,-3,5,377,1,0,England,France,3,3,0.28162,0.77706,4,winner,loser
Uruguay,Argentina,0,1,Friendly,Uruguay,14,12,1933,-1,1,1,378,1,1,Uruguay,Argentina,3,1,0.21308,0.9082,4,loser,winner
Belgium,France,2,3,Friendly,Belgium,21,1,1934,-1,1,5,379,1,0,Belgium,France,4,1,0.68313,0.42597,4,loser,winner
France,Switzerland,0,1,Friendly,France,11,3,1934,-1,1,1,380,0,0,France,Switzerland,4,1,0.81342,0.62585,4,loser,winner
Netherlands,Belgium,9,3,Friendly,Netherlands,11,3,1934,6,-6,12,381,1,1,Netherlands,Belgium,4,6,0.05832,0.73362,4,winner,loser
Spain,Portugal,9,0,FIFA World Cup qualification,Spain,11,3,1934,9,-9,9,382,1,1,Spain,Portugal,4,9,0.8918,0.51735,4,winner,loser
Portugal,Spain,1,2,FIFA World Cup qualification,Portugal,18,3,1934,-1,1,3,383,1,1,Portugal,Spain,4,1,0.76886,0.25657,4,loser,winner
Belgium,Netherlands,2,4,FIFA World Cup qualification,Belgium,29,4,1934,-2,2,6,384,1,1,Belgium,Netherlands,4,2,0.26879,0.98334,4,loser,winner
Netherlands,France,4,5,Friendly,Netherlands,10,5,1934,-1,1,9,385,1,0,Netherlands,France,4,1,0.95729,0.20574,4,loser,winner
Denmark,Poland,4,2,Friendly,Denmark,21,5,1934,2,-2,6,386,1,0,Denmark,Poland,4,2,0.55229,1.00E-05,4,winner,loser
Mexico,United States,2,4,FIFA World Cup qualification,Italy,24,5,1934,-2,2,6,387,1,0,Mexico,United_States,4,2,0.67592,0.05683,4,loser,winner
Belgium,Germany,2,5,FIFA World Cup,Italy,27,5,1934,-3,3,7,388,1,1,Belgium,Germany,4,3,0.75527,0.27441,4,loser,winner
Brazil,Spain,1,3,FIFA World Cup,Italy,27,5,1934,-2,2,4,389,0,1,Brazil,Spain,4,2,0.46574,0.30675,4,loser,winner
Netherlands,Switzerland,2,3,FIFA World Cup,Italy,27,5,1934,-1,1,5,390,1,0,Netherlands,Switzerland,4,1,0.007,0.15065,4,loser,winner
Uruguay,Argentina,2,2,Friendly,Uruguay,18,7,1934,0,0,4,391,1,1,Uruguay,Argentina,4,0,0.21238,0.38991,4,draw,draw
Argentina,Uruguay,1,0,Friendly,Argentina,15,8,1934,1,-1,1,392,1,1,Argentina,Uruguay,4,1,0.84354,0.86341,4,winner,loser
Poland,Germany,2,5,Friendly,Poland,9,9,1934,-3,3,7,393,0,1,Poland,Germany,4,3,0.68683,0.4642,4,loser,winner
Wales,England,0,4,British Championship,Wales,29,9,1934,-4,4,4,394,0,1,Wales,England,4,4,0.77402,0.9228,4,loser,winner
Denmark,Germany,2,5,Friendly,Denmark,7,10,1934,-3,3,7,395,1,1,Denmark,Germany,4,3,0.18555,0.78598,4,loser,winner
Switzerland,Netherlands,2,4,Friendly,Switzerland,4,11,1934,-2,2,6,396,0,1,Switzerland,Netherlands,4,2,0.17168,0.78285,4,loser,winner
Spain,France,2,0,Friendly,Spain,24,1,1935,2,-2,2,397,1,0,Spain,France,5,2,0.28261,0.08181,4,winner,loser
Argentina,Uruguay,0,3,Copa America,Peru,27,1,1935,-3,3,3,398,1,1,Argentina,Uruguay,5,3,0.82471,0.71634,4,loser,winner
Germany,Switzerland,4,0,Friendly,Germany,27,1,1935,4,-4,4,399,1,0,Germany,Switzerland,5,4,0.42369,0.44973,4,winner,loser
Netherlands,Germany,2,3,Friendly,Netherlands,17,2,1935,-1,1,5,400,1,1,Netherlands,Germany,5,1,0.65327,0.43753,4,loser,winner
France,Germany,1,3,Friendly,France,17,3,1935,-2,2,4,401,0,1,France,Germany,5,2,0.65677,0.3317,4,loser,winner
Netherlands,Belgium,4,2,Friendly,Netherlands,31,3,1935,2,-2,6,402,1,1,Netherlands,Belgium,5,2,0.35756,0.7292,4,winner,loser
Belgium,France,1,1,Friendly,Belgium,14,4,1935,0,0,2,403,1,0,Belgium,France,5,0,0.44515,0.83218,4,draw,draw
Belgium,Germany,1,6,Friendly,Belgium,28,4,1935,-5,5,7,404,1,1,Belgium,Germany,5,5,0.42709,0.52018,4,loser,winner
Portugal,Spain,3,3,Friendly,Portugal,5,5,1935,0,0,6,405,1,1,Portugal,Spain,5,0,0.4467,0.34445,4,draw,draw
Belgium,Netherlands,0,2,Friendly,Belgium,12,5,1935,-2,2,2,406,1,1,Belgium,Netherlands,5,2,0.43868,0.96212,4,loser,winner
Germany,Spain,1,2,Friendly,Germany,12,5,1935,-1,1,3,407,1,1,Germany,Spain,5,1,0.99669,0.44597,4,loser,winner
Netherlands,England,0,1,Friendly,Netherlands,18,5,1935,-1,1,1,408,1,1,Netherlands,England,5,1,0.31256,0.69266,4,loser,winner
Belgium,Switzerland,2,2,Friendly,Belgium,30,5,1935,0,0,4,409,1,0,Belgium,Switzerland,5,0,0.77644,0.8965,4,draw,draw
Uruguay,Argentina,1,1,Friendly,Uruguay,18,7,1935,0,0,2,410,1,1,Uruguay,Argentina,5,0,0.14418,0.04842,4,draw,draw
Argentina,Uruguay,3,0,Friendly,Argentina,15,8,1935,3,-3,3,411,1,1,Argentina,Uruguay,5,3,0.01191,0.2626,4,winner,loser
Germany,Poland,1,0,Friendly,Germany,15,9,1935,1,-1,1,412,1,0,Germany,Poland,5,1,0.22609,0.82909,4,winner,loser
Switzerland,France,2,1,Friendly,Switzerland,27,10,1935,1,-1,3,413,0,0,Switzerland,France,5,1,0.83882,0.60367,4,winner,loser
Netherlands,Denmark,3,0,Friendly,Netherlands,3,11,1935,3,-3,3,414,1,1,Netherlands,Denmark,5,3,0.38959,0.37521,4,winner,loser
England,Germany,3,0,Friendly,England,4,12,1935,3,-3,3,415,1,1,England,Germany,5,3,0.41054,0.12566,4,winner,loser
France,Netherlands,1,6,Friendly,France,12,1,1936,-5,5,7,416,0,1,France,Netherlands,6,5,0.64173,0.68263,4,loser,winner
England,Wales,1,2,British Championship,England,5,2,1936,-1,1,3,417,1,0,England,Wales,6,1,0.84955,0.20812,4,loser,winner
Belgium,Poland,0,2,Friendly,Belgium,16,2,1936,-2,2,2,418,1,0,Belgium,Poland,6,2,0.97326,0.73796,4,loser,winner
Spain,Germany,1,2,Friendly,Spain,23,2,1936,-1,1,3,419,1,1,Spain,Germany,6,1,0.79144,0.31973,4,loser,winner
Portugal,Germany,1,3,Friendly,Portugal,27,2,1936,-2,2,4,420,1,1,Portugal,Germany,6,2,0.03303,0.20865,4,loser,winner
France,Belgium,3,0,Friendly,France,8,3,1936,3,-3,3,421,0,1,France,Belgium,6,3,0.95437,0.18092,4,winner,loser
Netherlands,Belgium,8,0,Friendly,Netherlands,29,3,1936,8,-8,8,422,1,1,Netherlands,Belgium,6,8,0.98262,0.98744,4,winner,loser
Belgium,Netherlands,1,1,Friendly,Belgium,3,5,1936,0,0,2,423,1,1,Belgium,Netherlands,6,0,0.07494,0.21491,4,draw,draw
Switzerland,Spain,0,2,Friendly,Switzerland,3,5,1936,-2,2,2,424,0,1,Switzerland,Spain,6,2,0.72802,0.96479,4,loser,winner
Belgium,England,3,2,Friendly,Belgium,9,5,1936,1,-1,5,425,1,1,Belgium,England,6,1,0.14869,0.83786,4,winner,loser
Switzerland,Belgium,1,1,Friendly,Switzerland,24,5,1936,0,0,2,426,0,1,Switzerland,Belgium,6,0,0.95776,0.47176,4,draw,draw
Argentina,Uruguay,1,0,Friendly,Argentina,9,8,1936,1,-1,1,427,1,1,Argentina,Uruguay,6,1,0.76616,0.92803,4,winner,loser
Poland,Germany,1,1,Friendly,Poland,13,9,1936,0,0,2,428,0,1,Poland,Germany,6,0,0.15969,0.37855,4,draw,draw
Uruguay,Argentina,2,1,Friendly,Uruguay,20,9,1936,1,-1,3,429,1,1,Uruguay,Argentina,6,1,0.4807,0.44808,4,winner,loser
Denmark,Poland,2,1,Friendly,Denmark,4,10,1936,1,-1,3,430,1,0,Denmark,Poland,6,1,0.64823,0.23115,4,winner,loser
Wales,England,2,1,British Championship,Wales,17,10,1936,1,-1,3,431,0,1,Wales,England,6,1,0.53495,0.2043,4,winner,loser
Brazil,Uruguay,3,2,Copa America,Argentina,19,1,1937,1,-1,5,432,0,1,Brazil,Uruguay,7,1,0.79611,0.29898,4,winner,loser
Argentina,Uruguay,2,3,Copa America,Argentina,23,1,1937,-1,1,5,433,1,1,Argentina,Uruguay,7,1,0.1065,0.85448,4,loser,winner
Argentina,Brazil,1,0,Copa America,Argentina,30,1,1937,1,-1,1,434,1,0,Argentina,Brazil,7,1,0.72659,0.29986,4,winner,loser
Germany,Netherlands,2,2,Friendly,Germany,31,1,1937,0,0,4,435,1,1,Germany,Netherlands,7,0,0.40813,0.09854,4,draw,draw
Argentina,Brazil,2,0,Copa America,Argentina,1,2,1937,2,-2,2,436,1,0,Argentina,Brazil,7,2,0.87616,0.61622,4,winner,loser
Belgium,France,3,1,Friendly,Belgium,21,2,1937,2,-2,4,437,1,0,Belgium,France,7,2,0.17848,0.52466,4,winner,loser
Netherlands,Switzerland,2,1,Friendly,Netherlands,7,3,1937,1,-1,3,438,1,0,Netherlands,Switzerland,7,1,0.5633,0.29935,4,winner,loser
Germany,France,4,0,Friendly,Germany,21,3,1937,4,-4,4,439,1,0,Germany,France,7,4,0.76865,0.08628,4,winner,loser
Belgium,Netherlands,2,1,Friendly,Belgium,4,4,1937,1,-1,3,440,1,1,Belgium,Netherlands,7,1,0.50783,0.67121,4,winner,loser
Belgium,Switzerland,1,2,Friendly,Belgium,18,4,1937,-1,1,3,441,1,0,Belgium,Switzerland,7,1,0.43702,0.69307,4,loser,winner
Germany,Belgium,1,0,Friendly,Germany,25,4,1937,1,-1,1,442,1,1,Germany,Belgium,7,1,0.86453,0.04334,4,winner,loser
Netherlands,Belgium,1,0,Friendly,Netherlands,2,5,1937,1,-1,1,443,1,1,Netherlands,Belgium,7,1,0.06813,0.53109,4,winner,loser
Switzerland,Germany,0,1,Friendly,Switzerland,2,5,1937,-1,1,1,444,0,1,Switzerland,Germany,7,1,0.9992,0.18843,4,loser,winner
Germany,Denmark,8,0,Friendly,Germany,16,5,1937,8,-8,8,445,1,1,Germany,Denmark,7,8,0.85871,0.58026,4,winner,loser
Mexico,United States,7,2,Friendly,Mexico,12,9,1937,5,-5,9,446,1,0,Mexico,United_States,7,5,0.58385,0.78539,4,winner,loser
Poland,Denmark,3,1,Friendly,Poland,12,9,1937,2,-2,4,447,0,1,Poland,Denmark,7,2,0.32903,0.68855,4,winner,loser
Mexico,United States,7,3,Friendly,Mexico,19,9,1937,4,-4,10,448,1,0,Mexico,United_States,7,4,0.51107,0.13192,4,winner,loser
France,Switzerland,2,1,Friendly,France,10,10,1937,1,-1,3,449,0,0,France,Switzerland,7,1,0.44077,0.31757,4,winner,loser
Uruguay,Argentina,0,3,Copa Newton,Uruguay,10,10,1937,-3,3,3,450,1,1,Uruguay,Argentina,7,3,0.00882,0.92022,4,loser,winner
Netherlands,France,2,3,Friendly,Netherlands,31,10,1937,-1,1,5,451,1,0,Netherlands,France,7,1,0.47004,0.86377,4,loser,winner
Argentina,Uruguay,5,1,Copa Lipton,Argentina,11,11,1937,4,-4,6,452,1,1,Argentina,Uruguay,7,4,0.85693,0.10862,4,winner,loser
England,Wales,2,1,British Championship,England,17,11,1937,1,-1,3,453,1,0,England,Wales,7,1,0.74941,0.60735,4,winner,loser
Spain,Portugal,1,2,Friendly,Spain,28,11,1937,-1,1,3,454,1,1,Spain,Portugal,7,1,0.98918,0.9155,4,loser,winner
France,Belgium,5,3,Friendly,France,30,1,1938,2,-2,8,455,0,1,France,Belgium,8,2,0.60795,0.27232,4,winner,loser
Portugal,Spain,1,0,Friendly,Portugal,30,1,1938,1,-1,1,456,1,1,Portugal,Spain,8,1,0.2584,0.30147,4,winner,loser
Germany,Switzerland,1,1,Friendly,Germany,6,2,1938,0,0,2,457,1,0,Germany,Switzerland,8,0,0.2446,0.95936,4,draw,draw
Netherlands,Belgium,7,2,Friendly,Netherlands,27,2,1938,5,-5,9,458,1,1,Netherlands,Belgium,8,5,0.27495,0.95832,4,winner,loser
Switzerland,Poland,3,3,Friendly,Switzerland,13,3,1938,0,0,6,459,0,0,Switzerland,Poland,8,0,0.29682,0.4211,4,draw,draw
Belgium,Netherlands,1,1,FIFA World Cup qualification,Belgium,3,4,1938,0,0,2,460,1,1,Belgium,Netherlands,8,0,0.911,0.46464,4,draw,draw
Germany,Portugal,1,1,Friendly,Germany,24,4,1938,0,0,2,461,1,1,Germany,Portugal,8,0,0.52585,0.68202,4,draw,draw
Switzerland,Portugal,2,1,FIFA World Cup qualification,Italy,1,5,1938,1,-1,3,462,0,1,Switzerland,Portugal,8,1,0.25057,0.79271,4,winner,loser
Switzerland,Belgium,0,3,Friendly,Switzerland,8,5,1938,-3,3,3,463,0,1,Switzerland,Belgium,8,3,0.01084,0.45727,4,loser,winner
Germany,England,3,6,Friendly,Germany,14,5,1938,-3,3,9,464,1,1,Germany,England,8,3,0.6261,0.09248,4,loser,winner
Switzerland,England,2,1,Friendly,Switzerland,21,5,1938,1,-1,3,465,0,1,Switzerland,England,8,1,0.55518,0.9059,4,winner,loser
France,England,2,4,Friendly,France,26,5,1938,-2,2,6,466,0,1,France,England,8,2,0.48184,0.39559,4,loser,winner
Germany,Switzerland,1,1,FIFA World Cup,France,4,6,1938,0,0,2,467,1,0,Germany,Switzerland,8,0,0.34486,0.48619,4,draw,draw
Brazil,Poland,6,5,FIFA World Cup,France,5,6,1938,1,-1,11,468,0,0,Brazil,Poland,8,1,0.34948,0.68326,4,winner,loser
France,Belgium,3,1,FIFA World Cup,France,5,6,1938,2,-2,4,469,0,1,France,Belgium,8,2,0.77338,0.97266,4,winner,loser
Germany,Switzerland,2,4,FIFA World Cup,France,9,6,1938,-2,2,6,470,1,0,Germany,Switzerland,8,2,0.08388,0.65775,4,loser,winner
Argentina,Uruguay,1,0,Friendly,Argentina,18,6,1938,1,-1,1,471,1,1,Argentina,Uruguay,8,1,0.45563,0.73096,4,winner,loser
Germany,Poland,4,1,Friendly,Germany,18,9,1938,3,-3,5,472,1,0,Germany,Poland,8,3,0.97431,0.60263,4,winner,loser
Uruguay,Argentina,2,3,Friendly,Uruguay,12,10,1938,-1,1,5,473,1,1,Uruguay,Argentina,8,1,0.69888,0.58886,4,loser,winner
Wales,England,4,2,British Championship,Wales,22,10,1938,2,-2,6,474,0,1,Wales,England,8,2,0.33364,0.18415,4,winner,loser
Denmark,Netherlands,2,2,Friendly,Denmark,23,10,1938,0,0,4,475,1,1,Denmark,Netherlands,8,0,0.79534,0.71861,4,draw,draw
Switzerland,Portugal,1,0,Friendly,Switzerland,6,11,1938,1,-1,1,476,0,1,Switzerland,Portugal,8,1,0.25307,0.27098,4,winner,loser
Brazil,Argentina,1,5,Copa Roca,Brazil,15,1,1939,-4,4,6,477,0,1,Brazil,Argentina,9,4,0.40827,0.78146,4,loser,winner
Brazil,Argentina,3,2,Copa Roca,Brazil,22,1,1939,1,-1,5,478,0,1,Brazil,Argentina,9,1,0.77639,0.53577,4,winner,loser
Ecuador,Uruguay,0,6,Copa America,Peru,22,1,1939,-6,6,6,479,0,1,Ecuador,Uruguay,9,6,0.48571,0.00501,4,loser,winner
France,Poland,4,0,Friendly,France,22,1,1939,4,-4,4,480,0,0,France,Poland,9,4,0.21442,0.45496,4,winner,loser
Belgium,Germany,1,4,Friendly,Belgium,29,1,1939,-3,3,5,481,1,1,Belgium,Germany,9,3,0.05235,0.83895,4,loser,winner
Portugal,Switzerland,2,4,Friendly,Portugal,12,2,1939,-2,2,6,482,1,0,Portugal,Switzerland,9,2,0.26775,0.43192,4,loser,winner
Belgium,Netherlands,5,4,Friendly,Belgium,19,3,1939,1,-1,9,483,1,1,Belgium,Netherlands,9,1,0.63371,0.31255,4,winner,loser
Netherlands,Belgium,3,2,Friendly,Netherlands,23,4,1939,1,-1,5,484,1,1,Netherlands,Belgium,9,1,0.03297,0.8464,4,winner,loser
Switzerland,Netherlands,2,1,Friendly,Switzerland,7,5,1939,1,-1,3,485,0,1,Switzerland,Netherlands,9,1,0.49803,0.9547,4,winner,loser
Belgium,Switzerland,1,2,Friendly,Belgium,14,5,1939,-1,1,3,486,1,0,Belgium,Switzerland,9,1,0.81495,0.2737,4,loser,winner
Belgium,France,1,3,Friendly,Belgium,18,5,1939,-2,2,4,487,1,0,Belgium,France,9,2,0.72105,0.1524,4,loser,winner
France,Wales,2,1,Friendly,France,20,5,1939,1,-1,3,488,0,0,France,Wales,9,1,0.40479,0.75654,4,winner,loser
Poland,Belgium,3,3,Friendly,Poland,27,5,1939,0,0,6,489,0,1,Poland,Belgium,9,0,0.63652,0.47436,4,draw,draw
Poland,Switzerland,1,1,Friendly,Poland,4,6,1939,0,0,2,490,0,0,Poland,Switzerland,9,0,0.06213,0.57422,4,draw,draw
Denmark,Germany,0,2,Friendly,Denmark,25,6,1939,-2,2,2,491,1,1,Denmark,Germany,9,2,0.26978,0.58338,4,loser,winner
France,Portugal,3,2,Friendly,France,28,1,1940,1,-1,5,492,0,1,France,Portugal,0,1,0.13514,0.93257,5,winner,loser
Brazil,Argentina,2,2,Copa Roca,Brazil,18,2,1940,0,0,4,493,0,1,Brazil,Argentina,0,0,0.41969,0.80483,5,draw,draw
Brazil,Argentina,0,3,Copa Roca,Brazil,25,2,1940,-3,3,3,494,0,1,Brazil,Argentina,0,3,0.78054,0.97151,5,loser,winner
Argentina,Brazil,6,1,Copa Roca,Argentina,5,3,1940,5,-5,7,495,1,0,Argentina,Brazil,0,5,0.3486,0.03083,5,winner,loser
Argentina,Brazil,2,3,Copa Roca,Argentina,10,3,1940,-1,1,5,496,1,0,Argentina,Brazil,0,1,0.27138,0.7195,5,loser,winner
Argentina,Brazil,5,1,Copa Roca,Argentina,17,3,1940,4,-4,6,497,1,0,Argentina,Brazil,0,4,0.56103,0.14266,5,winner,loser
Belgium,Netherlands,7,1,Friendly,Belgium,17,3,1940,6,-6,8,498,1,1,Belgium,Netherlands,0,6,0.54179,0.76956,5,winner,loser
Brazil,Uruguay,3,4,Copa Rio Branco,Brazil,24,3,1940,-1,1,7,499,0,1,Brazil,Uruguay,0,1,0.75185,0.96675,5,loser,winner
Brazil,Uruguay,1,1,Copa Rio Branco,Brazil,31,3,1940,0,0,2,500,0,1,Brazil,Uruguay,0,0,0.07078,0.55064,5,draw,draw
Croatia,Switzerland,4,0,Friendly,Croatia,2,4,1940,4,-4,4,501,0,0,Croatia,Switzerland,0,4,0.08925,0.35093,5,winner,loser
Netherlands,Belgium,4,2,Friendly,Netherlands,21,4,1940,2,-2,6,502,1,1,Netherlands,Belgium,0,2,0.67635,0.12787,5,winner,loser
Switzerland,Croatia,0,1,Friendly,Switzerland,21,4,1940,-1,1,1,503,0,0,Switzerland,Croatia,0,1,0.46161,0.38249,5,loser,winner
Uruguay,Argentina,3,0,Friendly,Uruguay,18,7,1940,3,-3,3,504,1,1,Uruguay,Argentina,0,3,0.69498,0.89261,5,winner,loser
Argentina,Uruguay,5,0,Friendly,Argentina,15,8,1940,5,-5,5,505,1,1,Argentina,Uruguay,0,5,0.04137,0.12834,5,winner,loser
Germany,Denmark,1,0,Friendly,Germany,17,11,1940,1,-1,1,506,1,1,Germany,Denmark,0,1,0.31115,0.16223,5,winner,loser
Portugal,Spain,2,2,Friendly,Portugal,12,1,1941,0,0,4,507,1,1,Portugal,Spain,1,0,0.84083,0.72697,5,draw,draw
Ecuador,Uruguay,0,6,Copa America,Chile,9,2,1941,-6,6,6,508,0,1,Ecuador,Uruguay,1,6,0.8728,0.70437,5,loser,winner
Argentina,Ecuador,6,1,Copa America,Chile,16,2,1941,5,-5,7,509,1,0,Argentina,Ecuador,1,5,0.25091,0.27944,5,winner,loser
Argentina,Uruguay,1,0,Copa America,Chile,23,2,1941,1,-1,1,510,1,1,Argentina,Uruguay,1,1,0.31252,0.53648,5,winner,loser
Germany,Switzerland,4,2,Friendly,Germany,9,3,1941,2,-2,6,511,1,0,Germany,Switzerland,1,2,0.4279,0.53309,5,winner,loser
Spain,Portugal,5,1,Friendly,Spain,16,3,1941,4,-4,6,512,1,1,Spain,Portugal,1,4,0.03741,0.95406,5,winner,loser
Switzerland,Germany,2,1,Friendly,Switzerland,20,4,1941,1,-1,3,513,0,1,Switzerland,Germany,1,1,0.90528,0.24469,5,winner,loser
Germany,Croatia,5,1,Friendly,Germany,15,6,1941,4,-4,6,514,1,0,Germany,Croatia,1,4,0.901,0.36843,5,winner,loser
Germany,Denmark,1,1,Friendly,Germany,16,11,1941,0,0,2,515,1,1,Germany,Denmark,1,0,0.76714,0.09216,5,draw,draw
Spain,Switzerland,3,2,Friendly,Spain,28,12,1941,1,-1,5,516,1,0,Spain,Switzerland,1,1,0.12794,0.62672,5,winner,loser
Portugal,Switzerland,3,0,Friendly,Portugal,1,1,1942,3,-3,3,517,1,0,Portugal,Switzerland,2,3,0.25848,0.96527,5,winner,loser
Argentina,Brazil,2,1,Copa America,Uruguay,17,1,1942,1,-1,3,518,1,0,Argentina,Brazil,2,1,0.14805,0.12613,5,winner,loser
Uruguay,Ecuador,7,0,Copa America,Uruguay,18,1,1942,7,-7,7,519,1,0,Uruguay,Ecuador,2,7,0.35844,0.36823,5,winner,loser
Croatia,Germany,0,2,Friendly,Croatia,18,1,1942,-2,2,2,520,0,1,Croatia,Germany,2,2,0.33976,0.23306,5,loser,winner
Argentina,Ecuador,12,0,Copa America,Uruguay,22,1,1942,12,-12,12,521,1,0,Argentina,Ecuador,2,12,0.428,0.68643,5,winner,loser
Uruguay,Brazil,1,0,Copa America,Uruguay,24,1,1942,1,-1,1,522,1,0,Uruguay,Brazil,2,1,0.04012,0.96995,5,winner,loser
Brazil,Ecuador,5,1,Copa America,Uruguay,31,1,1942,4,-4,6,523,0,0,Brazil,Ecuador,2,4,0.28685,0.69035,5,winner,loser
Germany,Switzerland,1,2,Friendly,Germany,1,2,1942,-1,1,3,524,1,0,Germany,Switzerland,2,1,0.41793,0.33768,5,loser,winner
Uruguay,Argentina,1,0,Copa America,Uruguay,7,2,1942,1,-1,1,525,1,1,Uruguay,Argentina,2,1,0.54789,0.01315,5,winner,loser
France,Switzerland,0,2,Friendly,France,8,3,1942,-2,2,2,526,0,0,France,Switzerland,2,2,0.24596,0.60994,5,loser,winner
Spain,France,4,0,Friendly,Spain,15,3,1942,4,-4,4,527,1,0,Spain,France,2,4,0.21286,0.68958,5,winner,loser
Germany,Spain,1,1,Friendly,Germany,12,4,1942,0,0,2,528,1,1,Germany,Spain,2,0,0.82432,0.60715,5,draw,draw
Argentina,Uruguay,4,1,Copa Newton,Argentina,25,5,1942,3,-3,5,529,1,1,Argentina,Uruguay,2,3,0.60906,0.44374,5,winner,loser
Uruguay,Argentina,1,1,Copa Lipton,Uruguay,25,8,1942,0,0,2,530,1,1,Uruguay,Argentina,2,0,0.95679,0.52882,5,draw,draw
Switzerland,Germany,3,5,Friendly,Switzerland,18,10,1942,-2,2,8,531,0,1,Switzerland,Germany,2,2,0.83276,0.86319,5,loser,winner
Germany,Croatia,5,1,Friendly,Germany,1,11,1942,4,-4,6,532,1,0,Germany,Croatia,2,4,0.20074,0.75234,5,winner,loser
Argentina,Uruguay,3,3,Friendly,Argentina,28,3,1943,0,0,6,533,1,1,Argentina,Uruguay,3,0,0.77011,0.81561,5,draw,draw
Switzerland,Croatia,1,0,Friendly,Switzerland,4,4,1943,1,-1,1,534,0,0,Switzerland,Croatia,3,1,0.60192,0.73563,5,winner,loser
Uruguay,Argentina,0,1,Friendly,Uruguay,4,4,1943,-1,1,1,535,1,1,Uruguay,Argentina,3,1,0.77142,0.42977,5,loser,winner
Brazil,Uruguay,6,1,Friendly,Brazil,14,5,1944,5,-5,7,536,0,1,Brazil,Uruguay,4,5,0.73786,0.73777,5,winner,loser
Brazil,Uruguay,4,0,Friendly,Brazil,17,5,1944,4,-4,4,537,0,1,Brazil,Uruguay,4,4,0.86002,0.06128,5,winner,loser
France,Belgium,3,1,Friendly,France,24,12,1944,2,-2,4,538,0,1,France,Belgium,4,2,0.07559,0.44819,5,winner,loser
Ecuador,Uruguay,1,5,Copa America,Chile,24,1,1945,-4,4,6,539,0,1,Ecuador,Uruguay,5,4,0.13659,0.42638,5,loser,winner
Argentina,Ecuador,4,2,Copa America,Chile,31,1,1945,2,-2,6,540,1,0,Argentina,Ecuador,5,2,0.54708,0.28382,5,winner,loser
Brazil,Uruguay,3,0,Copa America,Chile,7,2,1945,3,-3,3,541,0,1,Brazil,Uruguay,5,3,0.50558,0.10966,5,winner,loser
Argentina,Brazil,3,1,Copa America,Chile,15,2,1945,2,-2,4,542,1,0,Argentina,Brazil,5,2,0.05053,0.86316,5,winner,loser
Brazil,Ecuador,9,2,Copa America,Chile,21,2,1945,7,-7,11,543,0,0,Brazil,Ecuador,5,7,0.89595,0.92774,5,winner,loser
Argentina,Uruguay,1,0,Copa America,Chile,25,2,1945,1,-1,1,544,1,1,Argentina,Uruguay,5,1,0.82222,0.25797,5,winner,loser
Portugal,Spain,2,2,Friendly,Portugal,11,3,1945,0,0,4,545,1,1,Portugal,Spain,5,0,0.80688,0.10555,5,draw,draw
Switzerland,France,1,0,Friendly,Switzerland,8,4,1945,1,-1,1,546,0,0,Switzerland,France,5,1,0.23494,0.62634,5,winner,loser
Spain,Portugal,4,2,Friendly,Spain,6,5,1945,2,-2,6,547,1,1,Spain,Portugal,5,2,0.02701,0.26472,5,winner,loser
Switzerland,Portugal,1,0,Friendly,Switzerland,21,5,1945,1,-1,1,548,0,1,Switzerland,Portugal,5,1,0.34271,0.43698,5,winner,loser
England,France,2,2,Friendly,England,26,5,1945,0,0,4,549,1,0,England,France,5,0,0.73715,0.18863,5,draw,draw
Uruguay,Argentina,2,2,Copa Lipton,Uruguay,18,7,1945,0,0,4,550,1,1,Uruguay,Argentina,5,0,0.35842,0.8389,5,draw,draw
Switzerland,England,3,1,Friendly,Switzerland,21,7,1945,2,-2,4,551,0,1,Switzerland,England,5,2,0.20929,0.65886,5,winner,loser
Argentina,Uruguay,6,2,Copa Newton,Argentina,15,8,1945,4,-4,8,552,1,1,Argentina,Uruguay,5,4,0.51115,0.41916,5,winner,loser
England,Wales,0,1,Friendly,England,20,10,1945,-1,1,1,553,1,0,England,Wales,5,1,0.09533,0.93643,5,loser,winner
Belgium,France,2,1,Friendly,Belgium,15,12,1945,1,-1,3,554,1,0,Belgium,France,5,1,0.83109,0.28204,5,winner,loser
Brazil,Argentina,3,4,Copa Roca,Brazil,16,12,1945,-1,1,7,555,0,1,Brazil,Argentina,5,1,0.01883,0.53559,5,loser,winner
Brazil,Argentina,6,2,Copa Roca,Brazil,20,12,1945,4,-4,8,556,0,1,Brazil,Argentina,5,4,0.63185,0.35555,5,winner,loser
Brazil,Argentina,3,1,Copa Roca,Brazil,23,12,1945,2,-2,4,557,0,1,Brazil,Argentina,5,2,0.30624,0.84834,5,winner,loser
Uruguay,Brazil,4,3,Copa Rio Branco,Uruguay,5,1,1946,1,-1,7,558,1,0,Uruguay,Brazil,6,1,0.35333,0.68629,5,winner,loser
England,Belgium,2,0,Friendly,England,19,1,1946,2,-2,2,559,1,1,England,Belgium,6,2,0.53629,0.80527,5,winner,loser
Brazil,Uruguay,4,3,Copa America,Argentina,23,1,1946,1,-1,7,560,0,1,Brazil,Uruguay,6,1,0.48581,0.34846,5,winner,loser
Argentina,Uruguay,3,1,Copa America,Argentina,2,2,1946,2,-2,4,561,1,1,Argentina,Uruguay,6,2,0.54684,0.93059,5,winner,loser
Argentina,Brazil,2,0,Copa America,Argentina,10,2,1946,2,-2,2,562,1,0,Argentina,Brazil,6,2,0.84148,0.15958,5,winner,loser
Portugal,France,2,1,Friendly,Portugal,14,4,1946,1,-1,3,563,1,0,Portugal,France,6,1,0.74787,0.13468,5,winner,loser
England,Switzerland,4,1,Friendly,England,11,5,1946,3,-3,5,564,1,0,England,Switzerland,6,3,0.961,0.48885,5,winner,loser
Netherlands,Belgium,6,3,Friendly,Netherlands,12,5,1946,3,-3,9,565,1,1,Netherlands,Belgium,6,3,0.63435,0.1824,5,winner,loser
France,England,2,1,Friendly,France,19,5,1946,1,-1,3,566,0,1,France,England,6,1,0.15636,0.90864,5,winner,loser
Belgium,Netherlands,2,2,Friendly,Belgium,30,5,1946,0,0,4,567,1,1,Belgium,Netherlands,6,0,0.20943,0.05882,5,draw,draw
England,Wales,3,0,British Championship,England,13,11,1946,3,-3,3,568,1,0,England,Wales,6,3,0.64884,0.06584,5,winner,loser
England,Netherlands,8,2,Friendly,England,27,11,1946,6,-6,10,569,1,1,England,Netherlands,6,6,0.77916,0.14061,5,winner,loser
Portugal,Switzerland,2,2,Friendly,Portugal,5,1,1947,0,0,4,570,1,0,Portugal,Switzerland,7,0,0.34666,0.76109,5,draw,draw
Portugal,Spain,4,1,Friendly,Portugal,26,1,1947,3,-3,5,571,1,1,Portugal,Spain,7,3,0.72314,0.31093,5,winner,loser
France,Portugal,1,0,Friendly,France,23,3,1947,1,-1,1,572,0,1,France,Portugal,7,1,0.54557,0.3398,5,winner,loser
Uruguay,Brazil,0,0,Copa Rio Branco,Uruguay,29,3,1947,0,0,0,573,1,0,Uruguay,Brazil,7,0,0.31921,0.19524,5,draw,draw
Brazil,Uruguay,3,2,Copa Rio Branco,Brazil,1,4,1947,1,-1,5,574,0,1,Brazil,Uruguay,7,1,0.44543,0.57681,5,winner,loser
Netherlands,Belgium,2,1,Friendly,Netherlands,7,4,1947,1,-1,3,575,1,1,Netherlands,Belgium,7,1,0.94728,0.88742,5,winner,loser
England,France,3,0,Friendly,England,3,5,1947,3,-3,3,576,1,0,England,France,7,3,0.69737,0.64702,5,winner,loser
Belgium,Netherlands,1,2,Friendly,Belgium,4,5,1947,-1,1,3,577,1,1,Belgium,Netherlands,7,1,0.205,0.20425,5,loser,winner
Switzerland,England,1,0,Friendly,Switzerland,18,5,1947,1,-1,1,578,0,1,Switzerland,England,7,1,0.18247,0.80229,5,winner,loser
Portugal,England,0,10,Friendly,Portugal,25,5,1947,-10,10,10,579,1,1,Portugal,England,7,10,0.73869,0.27791,5,loser,winner
France,Netherlands,4,0,Friendly,France,26,5,1947,4,-4,4,580,0,1,France,Netherlands,7,4,0.10638,0.74842,5,winner,loser
France,Belgium,4,2,Friendly,France,1,6,1947,2,-2,6,581,0,1,France,Belgium,7,2,0.93201,0.28757,5,winner,loser
Switzerland,France,1,2,Friendly,Switzerland,8,6,1947,-1,1,3,582,0,0,Switzerland,France,7,1,0.44312,0.52257,5,loser,winner
Mexico,United States,5,0,NAFU Championship,Cuba,13,7,1947,5,-5,5,583,1,0,Mexico,United_States,7,5,0.89216,0.18449,5,winner,loser
Belgium,England,2,5,Friendly,Belgium,21,9,1947,-3,3,7,584,1,1,Belgium,England,7,3,0.15312,0.87738,5,loser,winner
Netherlands,Switzerland,6,2,Friendly,Netherlands,21,9,1947,4,-4,8,585,1,0,Netherlands,Switzerland,7,4,0.67454,0.43941,5,winner,loser
Wales,England,0,3,British Championship,Wales,18,10,1947,-3,3,3,586,0,1,Wales,England,7,3,0.44736,0.82838,5,loser,winner
Switzerland,Belgium,4,0,Friendly,Switzerland,2,11,1947,4,-4,4,587,0,1,Switzerland,Belgium,7,4,0.41675,0.87427,5,winner,loser
Portugal,France,2,4,Friendly,Portugal,23,11,1947,-2,2,6,588,1,0,Portugal,France,7,2,0.92799,0.59323,5,loser,winner
Ecuador,Uruguay,1,6,Copa America,Ecuador,16,12,1947,-5,5,7,589,0,1,Ecuador,Uruguay,7,5,0.94949,0.19309,5,loser,winner
Ecuador,Argentina,0,2,Copa America,Ecuador,25,12,1947,-2,2,2,590,0,1,Ecuador,Argentina,7,2,0.48413,0.85767,5,loser,winner
Argentina,Uruguay,3,1,Copa America,Ecuador,28,12,1947,2,-2,4,591,1,1,Argentina,Uruguay,7,2,0.17123,0.82835,5,winner,loser
Belgium,Netherlands,1,1,Friendly,Belgium,14,3,1948,0,0,2,592,1,1,Belgium,Netherlands,8,0,0.70433,0.31155,5,draw,draw
Spain,Portugal,2,0,Friendly,Spain,21,3,1948,2,-2,2,593,1,1,Spain,Portugal,8,2,0.21898,0.17674,5,winner,loser
Uruguay,Brazil,1,1,Copa Rio Branco,Uruguay,4,4,1948,0,0,2,594,1,0,Uruguay,Brazil,8,0,0.73417,0.88242,5,draw,draw
Uruguay,Brazil,4,2,Copa Rio Branco,Uruguay,11,4,1948,2,-2,6,595,1,0,Uruguay,Brazil,8,2,0.85868,0.54884,5,winner,loser
Netherlands,Belgium,2,2,Friendly,Netherlands,18,4,1948,0,0,4,596,1,1,Netherlands,Belgium,8,0,0.33144,0.09074,5,draw,draw
Belgium,France,4,2,Friendly,Belgium,6,6,1948,2,-2,6,597,1,0,Belgium,France,8,2,0.65518,0.63153,5,winner,loser
Switzerland,Spain,3,3,Friendly,Switzerland,20,6,1948,0,0,6,598,0,1,Switzerland,Spain,8,0,0.25842,0.75749,5,draw,draw
Denmark,Poland,8,0,Friendly,Denmark,26,6,1948,8,-8,8,599,1,0,Denmark,Poland,8,8,0.19575,0.86868,5,winner,loser
Denmark,England,0,0,Friendly,Denmark,26,9,1948,0,0,0,600,1,1,Denmark,England,8,0,0.85069,0.65392,5,draw,draw
France,Belgium,3,3,Friendly,France,17,10,1948,0,0,6,601,0,1,France,Belgium,8,0,0.08599,0.86477,5,draw,draw
England,Wales,1,0,British Championship,England,10,11,1948,1,-1,1,602,1,0,England,Wales,8,1,0.20051,0.13931,5,winner,loser
Belgium,Netherlands,1,1,Friendly,Belgium,21,11,1948,0,0,2,603,1,1,Belgium,Netherlands,8,0,0.09526,0.15776,5,draw,draw
England,Switzerland,6,0,Friendly,England,2,12,1948,6,-6,6,604,1,0,England,Switzerland,8,6,0.13698,0.50912,5,winner,loser
Spain,Belgium,1,1,Friendly,Spain,2,1,1949,0,0,2,605,1,1,Spain,Belgium,9,0,0.21228,0.32715,5,draw,draw
Netherlands,Belgium,3,3,Friendly,Netherlands,13,3,1949,0,0,6,606,1,1,Netherlands,Belgium,9,0,0.65547,0.60947,5,draw,draw
Portugal,Spain,1,1,Friendly,Portugal,20,3,1949,0,0,2,607,1,1,Portugal,Spain,9,0,0.24066,0.5725,5,draw,draw
Brazil,Ecuador,9,1,Copa America,Brazil,3,4,1949,8,-8,10,608,0,0,Brazil,Ecuador,9,8,0.5851,0.41735,5,winner,loser
Ecuador,Uruguay,2,3,Copa America,Brazil,13,4,1949,-1,1,5,609,0,1,Ecuador,Uruguay,9,1,0.27308,0.38667,5,loser,winner
Netherlands,France,4,1,Friendly,Netherlands,23,4,1949,3,-3,5,610,1,0,Netherlands,France,9,3,0.78621,0.51564,5,winner,loser
Brazil,Uruguay,5,1,Copa America,Brazil,30,4,1949,4,-4,6,611,0,1,Brazil,Uruguay,9,4,0.76137,0.95975,5,winner,loser
Portugal,Wales,3,2,Friendly,Portugal,15,5,1949,1,-1,5,612,1,0,Portugal,Wales,9,1,0.83861,0.72484,5,winner,loser
Belgium,Wales,3,1,Friendly,Belgium,22,5,1949,2,-2,4,613,1,0,Belgium,Wales,9,2,0.3836,0.99545,5,winner,loser
France,England,1,3,Friendly,France,22,5,1949,-2,2,4,614,0,1,France,England,9,2,0.07736,0.33435,5,loser,winner
Switzerland,Wales,4,0,Friendly,Switzerland,26,5,1949,4,-4,4,615,0,0,Switzerland,Wales,9,4,0.27284,0.08116,5,winner,loser
France,Switzerland,4,2,Friendly,France,4,6,1949,2,-2,6,616,0,0,France,Switzerland,9,2,0.82107,0.51377,5,winner,loser
Denmark,Netherlands,1,2,Friendly,Denmark,12,6,1949,-1,1,3,617,1,1,Denmark,Netherlands,9,1,0.47674,0.33445,5,loser,winner
France,Spain,1,5,Friendly,France,19,6,1949,-4,4,6,618,0,1,France,Spain,9,4,0.87878,0.24272,5,loser,winner
Poland,Denmark,1,2,Friendly,Poland,19,6,1949,-1,1,3,619,0,1,Poland,Denmark,9,1,0.05953,0.65508,5,loser,winner
Mexico,United States,6,0,FIFA World Cup qualification,Mexico,4,9,1949,6,-6,6,620,1,0,Mexico,United_States,9,6,0.30759,0.22046,5,winner,loser
Mexico,United States,6,2,FIFA World Cup qualification,Mexico,18,9,1949,4,-4,8,621,1,0,Mexico,United_States,9,4,0.4977,0.01147,5,winner,loser
Belgium,Switzerland,3,0,Friendly,Belgium,2,10,1949,3,-3,3,622,1,0,Belgium,Switzerland,9,3,0.30122,0.21403,5,winner,loser
Wales,England,1,4,FIFA World Cup qualification,Wales,15,10,1949,-3,3,5,623,0,1,Wales,England,9,3,0.6569,0.13916,5,loser,winner
Netherlands,Belgium,0,1,Friendly,Netherlands,6,11,1949,-1,1,1,624,1,1,Netherlands,Belgium,9,1,0.86491,0.70783,5,loser,winner
Wales,Belgium,5,1,Friendly,Wales,23,11,1949,4,-4,6,625,0,1,Wales,Belgium,9,4,0.60159,0.78115,5,winner,loser
Netherlands,Denmark,0,1,Friendly,Netherlands,11,12,1949,-1,1,1,626,1,1,Netherlands,Denmark,9,1,0.47859,0.29422,5,loser,winner
Croatia,Serbia,4,1,Friendly,Yugoslavia,26,2,1950,3,-3,5,627,0,1,Croatia,Serbia,0,3,0.67715,0.61462,6,winner,loser
Spain,Portugal,5,1,FIFA World Cup qualification,Spain,2,4,1950,4,-4,6,628,1,1,Spain,Portugal,0,4,0.01574,0.02668,6,winner,loser
Portugal,Spain,2,2,FIFA World Cup qualification,Portugal,9,4,1950,0,0,4,629,1,1,Portugal,Spain,0,0,0.39297,0.69106,6,draw,draw
Belgium,Netherlands,2,0,Friendly,Belgium,16,4,1950,2,-2,2,630,1,1,Belgium,Netherlands,0,2,0.63167,0.76966,6,winner,loser
Brazil,Uruguay,3,4,Copa Rio Branco,Brazil,6,5,1950,-1,1,7,631,0,1,Brazil,Uruguay,0,1,0.28857,0.71909,6,loser,winner
Brazil,Uruguay,3,2,Copa Rio Branco,Brazil,14,5,1950,1,-1,5,632,0,1,Brazil,Uruguay,0,1,0.97833,0.52275,6,winner,loser
Portugal,England,3,5,Friendly,Portugal,14,5,1950,-2,2,8,633,1,1,Portugal,England,0,2,0.02891,0.74926,6,loser,winner
Belgium,England,1,4,Friendly,Belgium,18,5,1950,-3,3,5,634,1,1,Belgium,England,0,3,0.69417,0.40244,6,loser,winner
Belgium,France,4,1,Friendly,Belgium,4,6,1950,3,-3,5,635,1,0,Belgium,France,0,3,0.88639,0.30798,6,winner,loser
Brazil,Mexico,4,0,FIFA World Cup,Brazil,24,6,1950,4,-4,4,636,0,1,Brazil,Mexico,0,4,0.11617,0.75897,6,winner,loser
Spain,United States,3,1,FIFA World Cup,Brazil,25,6,1950,2,-2,4,637,1,0,Spain,United_States,0,2,0.75632,0.87296,6,winner,loser
Brazil,Switzerland,2,2,FIFA World Cup,Brazil,28,6,1950,0,0,4,638,0,0,Brazil,Switzerland,0,0,0.47386,0.73834,6,draw,draw
England,United States,0,1,FIFA World Cup,Brazil,29,6,1950,-1,1,1,639,1,0,England,United_States,0,1,0.13695,0.47612,6,loser,winner
England,Spain,0,1,FIFA World Cup,Brazil,2,7,1950,-1,1,1,640,1,1,England,Spain,0,1,0.08692,0.41711,6,loser,winner
Mexico,Switzerland,1,2,FIFA World Cup,Brazil,2,7,1950,-1,1,3,641,1,0,Mexico,Switzerland,0,1,0.54864,0.8596,6,loser,winner
Spain,Uruguay,2,2,FIFA World Cup,Brazil,9,7,1950,0,0,4,642,1,1,Spain,Uruguay,0,0,0.26971,0.98068,6,draw,draw
Brazil,Spain,6,1,FIFA World Cup,Brazil,13,7,1950,5,-5,7,643,0,1,Brazil,Spain,0,5,0.16528,0.11027,6,winner,loser
Brazil,Uruguay,1,2,FIFA World Cup,Brazil,16,7,1950,-1,1,3,644,0,1,Brazil,Uruguay,0,1,0.71545,0.96551,6,loser,winner
Switzerland,Netherlands,7,5,Friendly,Switzerland,15,10,1950,2,-2,12,645,0,1,Switzerland,Netherlands,0,2,0.67515,0.38095,6,winner,loser
France,Belgium,3,3,Friendly,France,1,11,1950,0,0,6,646,0,1,France,Belgium,0,0,0.7344,0.35277,6,draw,draw
Belgium,Netherlands,7,2,Friendly,Belgium,12,11,1950,5,-5,9,647,1,1,Belgium,Netherlands,0,5,0.03434,0.15358,6,winner,loser
England,Wales,4,2,British Championship,England,15,11,1950,2,-2,6,648,1,0,England,Wales,0,2,0.2391,0.89931,6,winner,loser
Germany,Switzerland,1,0,Friendly,Germany,22,11,1950,1,-1,1,649,1,0,Germany,Switzerland,0,1,0.50315,0.8748,6,winner,loser
France,Netherlands,5,2,Friendly,France,10,12,1950,3,-3,7,650,0,1,France,Netherlands,0,3,0.70882,0.1009,6,winner,loser
Spain,Switzerland,6,3,Friendly,Spain,18,2,1951,3,-3,9,651,1,0,Spain,Switzerland,1,3,0.82976,0.44783,6,winner,loser
Netherlands,Belgium,5,4,Friendly,Netherlands,15,4,1951,1,-1,9,652,1,1,Netherlands,Belgium,1,1,0.05651,0.43,6,winner,loser
Switzerland,Germany,2,3,Friendly,Switzerland,15,4,1951,-1,1,5,653,0,1,Switzerland,Germany,1,1,0.73671,0.14613,6,loser,winner
England,Argentina,2,1,Friendly,England,9,5,1951,1,-1,3,654,1,1,England,Argentina,1,1,0.45637,0.14734,6,winner,loser
Wales,Portugal,2,1,Friendly,Wales,12,5,1951,1,-1,3,655,0,1,Wales,Portugal,1,1,0.5628,0.98715,6,winner,loser
Wales,Switzerland,3,2,Friendly,Wales,16,5,1951,1,-1,5,656,0,0,Wales,Switzerland,1,1,0.07961,0.50057,6,winner,loser
England,Portugal,5,2,Friendly,England,19,5,1951,3,-3,7,657,1,1,England,Portugal,1,3,0.26722,0.13417,6,winner,loser
Belgium,Spain,3,3,Friendly,Belgium,10,6,1951,0,0,6,658,1,1,Belgium,Spain,1,0,0.96574,0.38264,6,draw,draw
Portugal,Belgium,1,1,Friendly,Portugal,17,6,1951,0,0,2,659,1,1,Portugal,Belgium,1,0,0.96869,0.33464,6,draw,draw
England,France,2,2,Friendly,England,3,10,1951,0,0,4,660,1,0,England,France,1,0,0.13136,0.52451,6,draw,draw
Switzerland,France,1,2,Friendly,Switzerland,14,10,1951,-1,1,3,661,0,0,Switzerland,France,1,1,0.96399,0.39396,6,loser,winner
Wales,England,1,1,British Championship,Wales,20,10,1951,0,0,2,662,0,1,Wales,England,1,0,0.73999,0.39168,6,draw,draw
Netherlands,Belgium,6,7,Friendly,Netherlands,25,11,1951,-1,1,13,663,1,1,Netherlands,Belgium,1,1,0.4097,0.92788,6,loser,winner
Mexico,Uruguay,1,3,Pan American Championship,Chile,23,3,1952,-2,2,4,664,1,1,Mexico,Uruguay,2,2,0.01171,0.95799,6,loser,winner
Belgium,Netherlands,4,2,Friendly,Belgium,6,4,1952,2,-2,6,665,1,1,Belgium,Netherlands,2,2,0.91765,0.78905,6,winner,loser
Brazil,Mexico,2,0,Pan American Championship,Chile,6,4,1952,2,-2,2,666,0,1,Brazil,Mexico,2,2,0.01922,0.16774,6,winner,loser
Brazil,Uruguay,4,2,Pan American Championship,Chile,16,4,1952,2,-2,6,667,0,1,Brazil,Uruguay,2,2,0.88542,0.74597,6,winner,loser
France,Portugal,3,0,Friendly,France,20,4,1952,3,-3,3,668,0,1,France,Portugal,2,3,0.11563,0.93238,6,winner,loser
Belgium,France,1,2,Friendly,Belgium,22,5,1952,-1,1,3,669,1,0,Belgium,France,2,1,0.24772,0.03503,6,loser,winner
Switzerland,England,0,3,Friendly,Switzerland,28,5,1952,-3,3,3,670,0,1,Switzerland,England,2,3,0.93551,0.46452,6,loser,winner
Denmark,Netherlands,3,2,Friendly,Denmark,21,9,1952,1,-1,5,671,1,1,Denmark,Netherlands,2,1,0.51736,0.8041,6,winner,loser
France,Germany,3,1,Friendly,France,5,10,1952,2,-2,4,672,0,1,France,Germany,2,2,0.66776,0.13146,6,winner,loser
Belgium,Netherlands,2,1,Friendly,Belgium,19,10,1952,1,-1,3,673,1,1,Belgium,Netherlands,2,1,0.93206,0.92768,6,winner,loser
Germany,Switzerland,5,1,Friendly,Germany,9,11,1952,4,-4,6,674,1,0,Germany,Switzerland,2,4,0.45879,0.36203,6,winner,loser
England,Wales,5,2,British Championship,England,12,11,1952,3,-3,7,675,1,0,England,Wales,2,3,0.52614,0.10363,6,winner,loser
England,Belgium,5,0,Friendly,England,26,11,1952,5,-5,5,676,1,1,England,Belgium,2,5,0.53224,0.38654,6,winner,loser
Spain,Argentina,0,1,Friendly,Spain,7,12,1952,-1,1,1,677,1,1,Spain,Argentina,2,1,0.09186,0.41079,6,loser,winner
Portugal,Argentina,1,3,Friendly,Portugal,14,12,1952,-2,2,4,678,1,1,Portugal,Argentina,2,2,0.24545,0.60218,6,loser,winner
France,Belgium,0,1,Friendly,France,25,12,1952,-1,1,1,679,0,1,France,Belgium,2,1,0.25229,0.35996,6,loser,winner
Spain,Germany,2,2,Friendly,Spain,28,12,1952,0,0,4,680,1,1,Spain,Germany,2,0,0.56176,0.10887,6,draw,draw
Netherlands,Denmark,1,2,Friendly,Netherlands,7,3,1953,-1,1,3,681,1,1,Netherlands,Denmark,3,1,0.66682,0.60612,6,loser,winner
Brazil,Ecuador,2,0,Copa America,Peru,12,3,1953,2,-2,2,682,0,0,Brazil,Ecuador,3,2,0.36354,0.59516,6,winner,loser
Brazil,Uruguay,1,0,Copa America,Peru,15,3,1953,1,-1,1,683,0,1,Brazil,Uruguay,3,1,0.97857,0.37715,6,winner,loser
Spain,Belgium,3,1,Friendly,Spain,19,3,1953,2,-2,4,684,1,1,Spain,Belgium,3,2,0.42226,0.65151,6,winner,loser
Netherlands,Switzerland,1,2,Friendly,Netherlands,22,3,1953,-1,1,3,685,1,0,Netherlands,Switzerland,3,1,0.05616,0.49957,6,loser,winner
Ecuador,Uruguay,0,6,Copa America,Peru,23,3,1953,-6,6,6,686,0,1,Ecuador,Uruguay,3,6,0.09809,0.82149,6,loser,winner
Netherlands,Belgium,0,2,Friendly,Netherlands,19,4,1953,-2,2,2,687,1,1,Netherlands,Belgium,3,2,0.80346,0.7934,6,loser,winner
Argentina,England,3,1,Friendly,Argentina,14,5,1953,2,-2,4,688,1,1,Argentina,England,3,2,0.31837,0.04228,6,winner,loser
France,Wales,6,1,Friendly,France,14,5,1953,5,-5,7,689,0,0,France,Wales,3,5,0.75915,0.63332,6,winner,loser
Argentina,England,0,0,Friendly,Argentina,17,5,1953,0,0,0,690,1,1,Argentina,England,3,0,0.83082,0.29676,6,draw,draw
Uruguay,England,2,1,Friendly,Uruguay,31,5,1953,1,-1,3,691,1,1,Uruguay,England,3,1,0.46607,0.11856,6,winner,loser
United States,England,3,6,Friendly,United States,8,6,1953,-3,3,9,692,0,1,United_States,England,3,3,0.26333,0.71531,6,loser,winner
Switzerland,Denmark,1,4,Friendly,Switzerland,27,6,1953,-3,3,5,693,0,1,Switzerland,Denmark,3,3,0.5736,0.36309,6,loser,winner
Argentina,Spain,1,0,Friendly,Argentina,5,7,1953,1,-1,1,694,1,1,Argentina,Spain,3,1,0.13598,0.24679,6,winner,loser
Wales,England,1,4,FIFA World Cup qualification,Wales,10,10,1953,-3,3,5,695,0,1,Wales,England,3,3,0.13581,0.53244,6,loser,winner
Netherlands,Belgium,1,0,Friendly,Netherlands,25,10,1953,1,-1,1,696,1,1,Netherlands,Belgium,3,1,0.45263,0.84654,6,winner,loser
France,Switzerland,2,4,Friendly,France,11,11,1953,-2,2,6,697,0,0,France,Switzerland,3,2,0.40184,0.85909,6,loser,winner
Switzerland,Belgium,2,2,Friendly,Switzerland,22,11,1953,0,0,4,698,0,1,Switzerland,Belgium,3,0,0.93819,0.38594,6,draw,draw
Mexico,United States,4,0,FIFA World Cup qualification,Mexico,10,1,1954,4,-4,4,699,1,0,Mexico,United_States,4,4,0.42062,0.52246,6,winner,loser
Mexico,United States,3,1,FIFA World Cup qualification,Mexico,14,1,1954,2,-2,4,700,1,0,Mexico,United_States,4,2,0.66034,0.74807,6,winner,loser
Japan,South Korea,1,5,FIFA World Cup qualification,Japan,7,3,1954,-4,4,6,701,0,0,Japan,South_Korea,4,4,0.04837,0.78629,6,loser,winner
Belgium,Portugal,0,0,Friendly,Belgium,14,3,1954,0,0,0,702,1,1,Belgium,Portugal,4,0,0.61222,0.41644,6,draw,draw
Japan,South Korea,2,2,FIFA World Cup qualification,Japan,14,3,1954,0,0,4,703,0,0,Japan,South_Korea,4,0,0.42564,0.45537,6,draw,draw
Belgium,Netherlands,4,0,Friendly,Belgium,4,4,1954,4,-4,4,704,1,1,Belgium,Netherlands,4,4,0.20824,0.47115,6,winner,loser
Switzerland,Germany,3,5,Friendly,Switzerland,25,4,1954,-2,2,8,705,0,1,Switzerland,Germany,4,2,0.24011,0.77507,6,loser,winner
Switzerland,Uruguay,3,3,Friendly,Switzerland,23,5,1954,0,0,6,706,0,1,Switzerland,Uruguay,4,0,0.37517,0.05937,6,draw,draw
Belgium,France,3,3,Friendly,Belgium,30,5,1954,0,0,6,707,1,0,Belgium,France,4,0,0.13652,0.44708,6,draw,draw
Switzerland,Netherlands,3,1,Friendly,Switzerland,30,5,1954,2,-2,4,708,0,1,Switzerland,Netherlands,4,2,0.39286,0.84019,6,winner,loser
Brazil,Mexico,5,0,FIFA World Cup,Switzerland,16,6,1954,5,-5,5,709,0,1,Brazil,Mexico,4,5,0.43969,0.15087,6,winner,loser
Belgium,England,4,4,FIFA World Cup,Switzerland,17,6,1954,0,0,8,710,1,1,Belgium,England,4,0,0.65315,0.35047,6,draw,draw
France,Mexico,3,2,FIFA World Cup,Switzerland,19,6,1954,1,-1,5,711,0,1,France,Mexico,4,1,0.49817,0.45196,6,winner,loser
Switzerland,England,0,2,FIFA World Cup,Switzerland,20,6,1954,-2,2,2,712,0,1,Switzerland,England,4,2,0.08245,0.05774,6,loser,winner
England,Uruguay,2,4,FIFA World Cup,Switzerland,26,6,1954,-2,2,6,713,1,1,England,Uruguay,4,2,0.39143,0.60134,6,loser,winner
Denmark,Switzerland,1,1,Friendly,Denmark,19,9,1954,0,0,2,714,1,0,Denmark,Switzerland,4,0,0.46109,0.4528,6,draw,draw
Belgium,Germany,2,0,Friendly,Belgium,26,9,1954,2,-2,2,715,1,1,Belgium,Germany,4,2,0.48455,0.15699,6,winner,loser
Germany,France,1,3,Friendly,Germany,16,10,1954,-2,2,4,716,1,0,Germany,France,4,2,0.09921,0.88523,6,loser,winner
Belgium,Netherlands,4,3,Friendly,Belgium,24,10,1954,1,-1,7,717,1,1,Belgium,Netherlands,4,1,0.09905,0.71274,6,winner,loser
England,Wales,3,2,British Championship,England,10,11,1954,1,-1,5,718,1,0,England,Wales,4,1,0.29306,0.87534,6,winner,loser
France,Belgium,2,2,Friendly,France,11,11,1954,0,0,4,719,0,1,France,Belgium,4,0,0.08284,0.4061,6,draw,draw
Portugal,Argentina,1,3,Friendly,Portugal,28,11,1954,-2,2,4,720,1,1,Portugal,Argentina,4,2,0.06115,0.67253,6,loser,winner
England,Germany,3,1,Friendly,England,1,12,1954,2,-2,4,721,1,1,England,Germany,4,2,0.17263,0.16732,6,winner,loser
Portugal,Germany,0,3,Friendly,Portugal,19,12,1954,-3,3,3,722,1,1,Portugal,Germany,4,3,0.5382,0.43509,6,loser,winner
Argentina,Ecuador,4,0,Copa America,Chile,9,3,1955,4,-4,4,723,1,0,Argentina,Ecuador,5,4,0.60214,0.15932,6,winner,loser
Netherlands,Denmark,1,1,Friendly,Netherlands,13,3,1955,0,0,2,724,1,1,Netherlands,Denmark,5,0,0.7617,0.83308,6,draw,draw
Spain,France,1,2,Friendly,Spain,17,3,1955,-1,1,3,725,1,0,Spain,France,5,1,0.48101,0.6358,6,loser,winner
Ecuador,Uruguay,1,5,Copa America,Chile,23,3,1955,-4,4,6,726,0,1,Ecuador,Uruguay,5,4,0.82798,0.87446,6,loser,winner
Argentina,Uruguay,6,1,Copa America,Chile,27,3,1955,5,-5,7,727,1,1,Argentina,Uruguay,5,5,0.46336,0.5617,6,winner,loser
Netherlands,Belgium,1,0,Friendly,Netherlands,3,4,1955,1,-1,1,728,1,1,Netherlands,Belgium,5,1,0.54965,0.83378,6,winner,loser
France,England,1,0,Friendly,France,15,5,1955,1,-1,1,729,0,1,France,England,5,1,0.97066,0.4796,6,winner,loser
Spain,England,1,1,Friendly,Spain,18,5,1955,0,0,2,730,1,1,Spain,England,5,0,0.14964,0.02991,6,draw,draw
Netherlands,Switzerland,4,1,Friendly,Netherlands,19,5,1955,3,-3,5,731,1,0,Netherlands,Switzerland,5,3,0.04027,0.49467,6,winner,loser
Portugal,England,3,1,Friendly,Portugal,22,5,1955,2,-2,4,732,1,1,Portugal,England,5,2,0.94565,0.01499,6,winner,loser
Switzerland,Spain,0,3,Friendly,Switzerland,19,6,1955,-3,3,3,733,0,1,Switzerland,Spain,5,3,0.73199,0.47,6,loser,winner
Denmark,England,1,5,Friendly,Denmark,2,10,1955,-4,4,6,734,1,1,Denmark,England,5,4,0.60455,0.16597,6,loser,winner
Switzerland,France,1,2,Friendly,Switzerland,9,10,1955,-1,1,3,735,0,0,Switzerland,France,5,1,0.47529,0.18431,6,loser,winner
Netherlands,Belgium,2,2,Friendly,Netherlands,16,10,1955,0,0,4,736,1,1,Netherlands,Belgium,5,0,0.70856,0.28485,6,draw,draw
Wales,England,2,1,British Championship,Wales,22,10,1955,1,-1,3,737,0,1,Wales,England,5,1,0.46629,0.9474,6,winner,loser
England,Spain,4,1,Friendly,England,30,11,1955,3,-3,5,738,1,1,England,Spain,5,3,0.36908,0.93419,6,winner,loser
Belgium,France,2,1,Friendly,Belgium,25,12,1955,1,-1,3,739,1,0,Belgium,France,5,1,0.64531,0.92354,6,winner,loser
Argentina,Brazil,0,1,Copa America,Uruguay,5,2,1956,-1,1,1,740,1,0,Argentina,Brazil,6,1,0.59316,0.23427,6,loser,winner
Uruguay,Brazil,0,0,Copa America,Uruguay,10,2,1956,0,0,0,741,1,0,Uruguay,Brazil,6,0,0.46837,0.48178,6,draw,draw
Uruguay,Argentina,1,0,Copa America,Uruguay,15,2,1956,1,-1,1,742,1,1,Uruguay,Argentina,6,1,0.86417,0.70605,6,winner,loser
Mexico,Costa Rica,1,1,Pan American Championship,Mexico,26,2,1956,0,0,2,743,1,1,Mexico,Costa_Rica,6,0,0.55273,0.42031,6,draw,draw
Argentina,Costa Rica,4,3,Pan American Championship,Mexico,6,3,1956,1,-1,7,744,1,1,Argentina,Costa_Rica,6,1,0.59414,0.72986,6,winner,loser
Mexico,Brazil,1,2,Pan American Championship,Mexico,8,3,1956,-1,1,3,745,1,0,Mexico,Brazil,6,1,0.40549,0.26859,6,loser,winner
Belgium,Switzerland,1,3,Friendly,Belgium,11,3,1956,-2,2,4,746,1,0,Belgium,Switzerland,6,2,0.48036,0.70661,6,loser,winner
Brazil,Costa Rica,7,1,Pan American Championship,Mexico,13,3,1956,6,-6,8,747,0,1,Brazil,Costa_Rica,6,6,0.37717,0.12869,6,winner,loser
Mexico,Argentina,0,0,Pan American Championship,Mexico,13,3,1956,0,0,0,748,1,1,Mexico,Argentina,6,0,0.60739,0.10061,6,draw,draw
Germany,Netherlands,1,2,Friendly,Germany,14,3,1956,-1,1,3,749,1,1,Germany,Netherlands,6,1,0.55225,0.95622,6,loser,winner
Argentina,Brazil,2,2,Pan American Championship,Mexico,18,3,1956,0,0,4,750,1,0,Argentina,Brazil,6,0,0.06904,0.34244,6,draw,draw
Belgium,Netherlands,0,1,Friendly,Belgium,8,4,1956,-1,1,1,751,1,1,Belgium,Netherlands,6,1,0.73898,0.01921,6,loser,winner
Portugal,Brazil,0,1,Friendly,Portugal,8,4,1956,-1,1,1,752,1,0,Portugal,Brazil,6,1,0.58715,0.43029,6,loser,winner
Switzerland,Brazil,1,1,Friendly,Switzerland,11,4,1956,0,0,2,753,0,0,Switzerland,Brazil,6,0,0.68799,0.04102,6,draw,draw
England,Brazil,4,2,Friendly,England,9,5,1956,2,-2,6,754,1,0,England,Brazil,6,2,0.58877,0.58157,6,winner,loser
Germany,England,1,3,Friendly,Germany,26,5,1956,-2,2,4,755,1,1,Germany,England,6,2,0.83668,0.21359,6,loser,winner
Portugal,Spain,3,1,Friendly,Portugal,3,6,1956,2,-2,4,756,1,1,Portugal,Spain,6,2,0.56938,0.12759,6,winner,loser
Brazil,Uruguay,2,0,Atlantic Cup,Brazil,24,6,1956,2,-2,2,757,0,1,Brazil,Uruguay,6,2,0.13732,0.24787,6,winner,loser
Uruguay,Argentina,1,2,Atlantic Cup,Uruguay,1,7,1956,-1,1,3,758,1,1,Uruguay,Argentina,6,1,0.0967,0.68189,6,loser,winner
Argentina,Brazil,0,0,Atlantic Cup,Argentina,8,7,1956,0,0,0,759,1,0,Argentina,Brazil,6,0,0.09609,0.95842,6,draw,draw
Switzerland,Netherlands,2,3,Friendly,Switzerland,15,9,1956,-1,1,5,760,0,1,Switzerland,Netherlands,6,1,0.19096,0.26924,6,loser,winner
Uruguay,Argentina,1,2,Friendly,Uruguay,10,10,1956,-1,1,3,761,1,1,Uruguay,Argentina,6,1,0.93775,0.27193,6,loser,winner
Belgium,Netherlands,2,3,Friendly,Belgium,14,10,1956,-1,1,5,762,1,1,Belgium,Netherlands,6,1,0.41881,0.68537,6,loser,winner
South Korea,United States,1,0,Friendly,South Korea,31,10,1956,1,-1,1,763,0,0,South_Korea,United_States,6,1,0.97089,0.60841,6,winner,loser
Denmark,Netherlands,2,2,Friendly,Denmark,4,11,1956,0,0,4,764,1,1,Denmark,Netherlands,6,0,0.89211,0.21865,6,draw,draw
France,Belgium,6,3,FIFA World Cup qualification,France,11,11,1956,3,-3,9,765,0,1,France,Belgium,6,3,0.27976,0.23053,6,winner,loser
Argentina,Uruguay,2,2,Friendly,Argentina,14,11,1956,0,0,4,766,1,1,Argentina,Uruguay,6,0,0.80405,0.40949,6,draw,draw
England,Wales,3,1,British Championship,England,14,11,1956,2,-2,4,767,1,0,England,Wales,6,2,0.24764,0.97825,6,winner,loser
Germany,Switzerland,1,3,Friendly,Germany,21,11,1956,-2,2,4,768,1,0,Germany,Switzerland,6,2,0.66512,0.79237,6,loser,winner
England,Denmark,5,2,FIFA World Cup qualification,England,5,12,1956,3,-3,7,769,1,1,England,Denmark,6,3,0.19962,0.12351,6,winner,loser
Germany,Belgium,4,1,Friendly,Germany,23,12,1956,3,-3,5,770,1,1,Germany,Belgium,6,3,0.9268,0.36186,6,winner,loser
Spain,Netherlands,5,1,Friendly,Spain,30,1,1957,4,-4,6,771,1,1,Spain,Netherlands,7,4,0.7798,0.80193,6,winner,loser
Ecuador,Uruguay,2,5,Copa America,Peru,7,3,1957,-3,3,7,772,0,1,Ecuador,Uruguay,7,3,0.69797,0.97947,6,loser,winner
Spain,Switzerland,2,2,FIFA World Cup qualification,Spain,10,3,1957,0,0,4,773,1,0,Spain,Switzerland,7,0,0.18374,0.23682,6,draw,draw
Argentina,Ecuador,3,0,Copa America,Peru,17,3,1957,3,-3,3,774,1,0,Argentina,Ecuador,7,3,0.04898,0.76519,6,winner,loser
Argentina,Uruguay,4,0,Copa America,Peru,20,3,1957,4,-4,4,775,1,1,Argentina,Uruguay,7,4,0.67682,0.52811,6,winner,loser
Brazil,Ecuador,7,1,Copa America,Peru,21,3,1957,6,-6,8,776,0,0,Brazil,Ecuador,7,6,0.01064,0.07465,6,winner,loser
Brazil,Uruguay,2,3,Copa America,Peru,28,3,1957,-1,1,5,777,0,1,Brazil,Uruguay,7,1,0.73555,0.15064,6,loser,winner
Belgium,Spain,0,5,Friendly,Belgium,31,3,1957,-5,5,5,778,1,1,Belgium,Spain,7,5,0.88938,0.10642,6,loser,winner
Argentina,Brazil,3,0,Copa America,Peru,3,4,1957,3,-3,3,779,1,0,Argentina,Brazil,7,3,0.82348,0.83591,6,winner,loser
Netherlands,Germany,1,2,Friendly,Netherlands,3,4,1957,-1,1,3,780,1,1,Netherlands,Germany,7,1,0.3809,0.02525,6,loser,winner
Mexico,United States,6,0,FIFA World Cup qualification,Mexico,7,4,1957,6,-6,6,781,1,0,Mexico,United_States,7,6,0.4034,0.50679,6,winner,loser
Netherlands,Belgium,1,1,Friendly,Netherlands,28,4,1957,0,0,2,782,1,1,Netherlands,Belgium,7,0,0.51479,0.54975,6,draw,draw
United States,Mexico,2,7,FIFA World Cup qualification,United States,28,4,1957,-5,5,9,783,0,1,United_States,Mexico,7,5,0.89036,0.92767,6,loser,winner
Denmark,England,1,4,FIFA World Cup qualification,Denmark,15,5,1957,-3,3,5,784,1,1,Denmark,England,7,3,0.59772,0.20402,6,loser,winner
Uruguay,Argentina,0,0,Copa Newton,Uruguay,23,5,1957,0,0,0,785,1,1,Uruguay,Argentina,7,0,0.93714,0.15437,6,draw,draw
Argentina,Uruguay,1,1,Copa Lipton,Argentina,5,6,1957,0,0,2,786,1,1,Argentina,Uruguay,7,0,0.56185,0.93081,6,draw,draw
Brazil,Portugal,2,1,Friendly,Brazil,11,6,1957,1,-1,3,787,0,1,Brazil,Portugal,7,1,0.92114,0.26855,6,winner,loser
Brazil,Portugal,3,0,Friendly,Brazil,16,6,1957,3,-3,3,788,0,1,Brazil,Portugal,7,3,0.31029,0.64714,6,winner,loser
Canada,United States,5,1,FIFA World Cup qualification,Canada,22,6,1957,4,-4,6,789,0,0,Canada,United_States,7,4,0.78174,0.14163,6,winner,loser
Mexico,Canada,3,0,FIFA World Cup qualification,Mexico,30,6,1957,3,-3,3,790,1,0,Mexico,Canada,7,3,0.91683,0.32666,6,winner,loser
Mexico,Canada,2,0,FIFA World Cup qualification,Mexico,3,7,1957,2,-2,2,791,1,0,Mexico,Canada,7,2,0.39588,0.33554,6,winner,loser
United States,Canada,2,3,FIFA World Cup qualification,United States,6,7,1957,-1,1,5,792,0,0,United_States,Canada,7,1,0.2813,0.45616,6,loser,winner
Brazil,Argentina,1,2,Copa Roca,Brazil,7,7,1957,-1,1,3,793,0,1,Brazil,Argentina,7,1,0.21322,0.70301,6,loser,winner
Brazil,Argentina,2,0,Copa Roca,Brazil,10,7,1957,2,-2,2,794,0,1,Brazil,Argentina,7,2,0.90567,0.09878,6,winner,loser
Wales,England,0,4,British Championship,Wales,19,10,1957,-4,4,4,795,0,1,Wales,England,7,4,0.99429,0.26346,6,loser,winner
Mexico,Costa Rica,2,0,FIFA World Cup qualification,Mexico,20,10,1957,2,-2,2,796,1,1,Mexico,Costa_Rica,7,2,0.95063,0.62927,6,winner,loser
Belgium,France,0,0,FIFA World Cup qualification,Belgium,27,10,1957,0,0,0,797,1,0,Belgium,France,7,0,0.00313,0.28238,6,draw,draw
Costa Rica,Mexico,1,1,FIFA World Cup qualification,Costa Rica,27,10,1957,0,0,2,798,1,1,Costa_Rica,Mexico,7,0,0.9159,0.54965,6,draw,draw
Netherlands,Belgium,5,2,Friendly,Netherlands,17,11,1957,3,-3,7,799,1,1,Netherlands,Belgium,7,3,0.14058,0.64032,6,winner,loser
Switzerland,Spain,1,4,FIFA World Cup qualification,Switzerland,24,11,1957,-3,3,5,800,0,1,Switzerland,Spain,7,3,0.6803,0.75514,6,loser,winner
England,France,4,0,Friendly,England,27,11,1957,4,-4,4,801,1,0,England,France,7,4,0.26352,0.62388,6,winner,loser
Belgium,Germany,0,2,Friendly,Belgium,2,3,1958,-2,2,2,802,1,1,Belgium,Germany,8,2,0.78104,0.25314,6,loser,winner
France,Spain,2,2,Friendly,France,13,3,1958,0,0,4,803,0,1,France,Spain,8,0,0.77385,0.63217,6,draw,draw
Germany,Spain,2,0,Friendly,Germany,19,3,1958,2,-2,2,804,1,1,Germany,Spain,8,2,0.38933,0.95427,6,winner,loser
Uruguay,Argentina,1,0,Friendly,Uruguay,6,4,1958,1,-1,1,805,1,1,Uruguay,Argentina,8,1,0.97584,0.48532,6,winner,loser
Belgium,Netherlands,2,7,Friendly,Belgium,13,4,1958,-5,5,9,806,1,1,Belgium,Netherlands,8,5,0.10617,0.78373,6,loser,winner
Spain,Portugal,1,0,Friendly,Spain,13,4,1958,1,-1,1,807,1,1,Spain,Portugal,8,1,0.41279,0.72863,6,winner,loser
France,Switzerland,0,0,Friendly,France,16,4,1958,0,0,0,808,0,0,France,Switzerland,8,0,0.59625,0.12439,6,draw,draw
Argentina,Uruguay,2,0,Friendly,Argentina,30,4,1958,2,-2,2,809,1,1,Argentina,Uruguay,8,2,0.82275,0.9142,6,winner,loser
England,Portugal,2,1,Friendly,England,7,5,1958,1,-1,3,810,1,1,England,Portugal,8,1,0.94535,0.27377,6,winner,loser
Denmark,Poland,3,2,Friendly,Denmark,25,5,1958,1,-1,5,811,1,0,Denmark,Poland,8,1,0.5275,0.93833,6,winner,loser
Switzerland,Belgium,0,2,Friendly,Switzerland,26,5,1958,-2,2,2,812,0,1,Switzerland,Belgium,8,2,0.30123,0.32589,6,loser,winner
Argentina,Germany,1,3,FIFA World Cup,Sweden,8,6,1958,-2,2,4,813,1,1,Argentina,Germany,8,2,0.88584,0.09579,6,loser,winner
Brazil,England,0,0,FIFA World Cup,Sweden,11,6,1958,0,0,0,814,0,1,Brazil,England,8,0,0.91246,0.71426,6,draw,draw
Mexico,Wales,1,1,FIFA World Cup,Sweden,11,6,1958,0,0,2,815,1,0,Mexico,Wales,8,0,0.00918,0.3723,6,draw,draw
Brazil,Wales,1,0,FIFA World Cup,Sweden,19,6,1958,1,-1,1,816,0,0,Brazil,Wales,8,1,0.06958,0.66969,6,winner,loser
Brazil,France,5,2,FIFA World Cup,Sweden,24,6,1958,3,-3,7,817,0,0,Brazil,France,8,3,0.02251,0.23211,6,winner,loser
France,Germany,6,3,FIFA World Cup,Sweden,28,6,1958,3,-3,9,818,0,1,France,Germany,8,3,0.08452,0.30507,6,winner,loser
Denmark,Germany,1,1,Friendly,Denmark,24,9,1958,0,0,2,819,1,1,Denmark,Germany,8,0,0.89137,0.09501,6,draw,draw
Belgium,Netherlands,2,3,Friendly,Belgium,28,9,1958,-1,1,5,820,1,1,Belgium,Netherlands,8,1,0.0418,0.86306,6,loser,winner
Netherlands,Denmark,5,1,Friendly,Netherlands,15,10,1958,4,-4,6,821,1,1,Netherlands,Denmark,8,4,0.51501,0.48064,6,winner,loser
France,Germany,2,2,Friendly,France,26,10,1958,0,0,4,822,0,1,France,Germany,8,0,0.29939,0.42365,6,draw,draw
Netherlands,Switzerland,2,0,Friendly,Netherlands,2,11,1958,2,-2,2,823,1,0,Netherlands,Switzerland,8,2,0.97735,0.83142,6,winner,loser
England,Wales,2,2,British Championship,England,26,11,1958,0,0,4,824,1,0,England,Wales,8,0,0.73231,0.05235,6,draw,draw
France,Belgium,2,2,Friendly,France,1,3,1959,0,0,4,825,0,1,France,Belgium,9,0,0.62148,0.76446,6,draw,draw
Mexico,Costa Rica,3,1,Friendly,Mexico,1,3,1959,2,-2,4,826,1,1,Mexico,Costa_Rica,9,2,0.22076,0.63853,6,winner,loser
Costa Rica,Mexico,1,2,Friendly,Costa Rica,8,3,1959,-1,1,3,827,1,1,Costa_Rica,Mexico,9,1,0.40756,0.16533,6,loser,winner
Brazil,Uruguay,3,1,Copa America,Argentina,26,3,1959,2,-2,4,828,0,1,Brazil,Uruguay,9,2,0.49432,0.28449,6,winner,loser
Argentina,Uruguay,4,1,Copa America,Argentina,30,3,1959,3,-3,5,829,1,1,Argentina,Uruguay,9,3,0.06736,0.20582,6,winner,loser
Argentina,Brazil,1,1,Copa America,Argentina,4,4,1959,0,0,2,830,1,0,Argentina,Brazil,9,0,0.51602,0.62488,6,draw,draw
Netherlands,Belgium,2,2,Friendly,Netherlands,19,4,1959,0,0,4,831,1,1,Netherlands,Belgium,9,0,0.2897,0.6544,6,draw,draw
Brazil,England,2,0,Friendly,Brazil,13,5,1959,2,-2,2,832,0,1,Brazil,England,9,2,0.82295,0.7991,6,winner,loser
Switzerland,Portugal,4,3,Friendly,Switzerland,16,5,1959,1,-1,7,833,0,1,Switzerland,Portugal,9,1,0.79597,0.17308,6,winner,loser
Germany,Poland,1,1,Friendly,Germany,20,5,1959,0,0,2,834,1,0,Germany,Poland,9,0,0.22534,0.74234,6,draw,draw
Mexico,England,2,1,Friendly,Mexico,24,5,1959,1,-1,3,835,1,1,Mexico,England,9,1,0.95166,0.11683,6,winner,loser
United States,England,1,8,Friendly,United States,28,5,1959,-7,7,9,836,0,1,United_States,England,9,7,0.4488,0.10162,6,loser,winner
Poland,Spain,2,4,UEFA Euro qualification,Poland,28,6,1959,-2,2,6,837,0,1,Poland,Spain,9,2,0.73607,0.7728,6,loser,winner
Japan,South Korea,0,0,Merdeka Tournament,Malaya,5,9,1959,0,0,0,838,0,0,Japan,South_Korea,9,0,0.68335,0.62867,6,draw,draw
Japan,South Korea,1,3,Merdeka Tournament,Malaya,6,9,1959,-2,2,4,839,0,0,Japan,South_Korea,9,2,0.94867,0.88405,6,loser,winner
Netherlands,Belgium,9,1,Friendly,Netherlands,4,10,1959,8,-8,10,840,1,1,Netherlands,Belgium,9,8,0.62337,0.6424,6,winner,loser
Switzerland,Germany,0,4,Friendly,Switzerland,4,10,1959,-4,4,4,841,0,1,Switzerland,Germany,9,4,0.61598,0.01966,6,loser,winner
Spain,Poland,3,0,UEFA Euro qualification,Spain,14,10,1959,3,-3,3,842,1,0,Spain,Poland,9,3,0.8456,0.05213,6,winner,loser
Wales,England,1,1,British Championship,Wales,17,10,1959,0,0,2,843,0,1,Wales,England,9,0,0.75179,0.4146,6,draw,draw
Germany,Netherlands,7,0,Friendly,Germany,21,10,1959,7,-7,7,844,1,1,Germany,Netherlands,9,7,0.58494,0.64785,6,winner,loser
France,Portugal,5,3,Friendly,France,11,11,1959,2,-2,8,845,0,1,France,Portugal,9,2,0.87337,0.88471,6,winner,loser
Ecuador,Uruguay,0,4,Copa America,Ecuador,6,12,1959,-4,4,4,846,0,1,Ecuador,Uruguay,9,4,0.37964,0.31487,6,loser,winner
Brazil,Uruguay,0,3,Copa America,Ecuador,12,12,1959,-3,3,3,847,0,1,Brazil,Uruguay,9,3,0.66809,0.50117,6,loser,winner
Ecuador,Argentina,1,1,Copa America,Ecuador,12,12,1959,0,0,2,848,0,1,Ecuador,Argentina,9,0,0.72106,0.13209,6,draw,draw
Argentina,Uruguay,0,5,Copa America,Ecuador,16,12,1959,-5,5,5,849,1,1,Argentina,Uruguay,9,5,0.37713,0.55042,6,loser,winner
France,Spain,4,3,Friendly,France,17,12,1959,1,-1,7,850,0,1,France,Spain,9,1,0.9224,0.05781,6,winner,loser
Ecuador,Brazil,1,3,Copa America,Ecuador,19,12,1959,-2,2,4,851,0,0,Ecuador,Brazil,9,2,0.21748,0.22294,6,loser,winner
Argentina,Brazil,4,1,Copa America,Ecuador,22,12,1959,3,-3,5,852,1,0,Argentina,Brazil,9,3,0.70389,0.91741,6,winner,loser
Ecuador,Brazil,1,2,Friendly,Ecuador,27,12,1959,-1,1,3,853,0,0,Ecuador,Brazil,9,1,0.70506,0.22274,6,loser,winner
Belgium,France,1,0,Friendly,Belgium,28,2,1960,1,-1,1,854,1,0,Belgium,France,0,1,0.90519,0.67761,7,winner,loser
Brazil,Mexico,2,2,Pan American Championship,Costa Rica,6,3,1960,0,0,4,855,0,1,Brazil,Mexico,0,0,0.68392,0.85988,7,draw,draw
Costa Rica,Argentina,0,0,Pan American Championship,Costa Rica,8,3,1960,0,0,0,856,1,1,Costa_Rica,Argentina,0,0,0.49397,0.62216,7,draw,draw
Argentina,Mexico,3,2,Pan American Championship,Costa Rica,10,3,1960,1,-1,5,857,1,1,Argentina,Mexico,0,1,0.75961,0.68337,7,winner,loser
Costa Rica,Brazil,3,0,Pan American Championship,Costa Rica,10,3,1960,3,-3,3,858,1,0,Costa_Rica,Brazil,0,3,0.73151,0.81176,7,winner,loser
Argentina,Brazil,2,1,Pan American Championship,Costa Rica,13,3,1960,1,-1,3,859,1,0,Argentina,Brazil,0,1,0.55747,0.69965,7,winner,loser
Brazil,Mexico,2,1,Pan American Championship,Costa Rica,15,3,1960,1,-1,3,860,0,1,Brazil,Mexico,0,1,0.81148,0.59163,7,winner,loser
Costa Rica,Argentina,0,2,Pan American Championship,Costa Rica,15,3,1960,-2,2,2,861,1,1,Costa_Rica,Argentina,0,2,0.73569,0.47021,7,loser,winner
Argentina,Mexico,2,0,Pan American Championship,Costa Rica,17,3,1960,2,-2,2,862,1,1,Argentina,Mexico,0,2,0.55013,0.40083,7,winner,loser
Costa Rica,Brazil,0,4,Pan American Championship,Costa Rica,17,3,1960,-4,4,4,863,1,0,Costa_Rica,Brazil,0,4,0.02457,0.44586,7,loser,winner
Argentina,Brazil,0,1,Pan American Championship,Costa Rica,20,3,1960,-1,1,1,864,1,0,Argentina,Brazil,0,1,0.50834,0.1705,7,loser,winner
Belgium,Switzerland,3,1,Friendly,Belgium,27,3,1960,2,-2,4,865,1,0,Belgium,Switzerland,0,2,0.18057,0.13535,7,winner,loser
Belgium,Netherlands,2,1,Friendly,Belgium,24,4,1960,1,-1,3,866,1,1,Belgium,Netherlands,0,1,0.30871,0.90477,7,winner,loser
Germany,Portugal,2,1,Friendly,Germany,27,4,1960,1,-1,3,867,1,1,Germany,Portugal,0,1,0.83269,0.17066,7,winner,loser
Denmark,Brazil,3,4,Friendly,Denmark,10,5,1960,-1,1,7,868,1,0,Denmark,Brazil,0,1,0.59821,0.89758,7,loser,winner
Spain,England,3,0,Friendly,Spain,15,5,1960,3,-3,3,869,1,1,Spain,England,0,3,0.29143,0.19818,7,winner,loser
Switzerland,Netherlands,3,1,Friendly,Switzerland,18,5,1960,2,-2,4,870,0,1,Switzerland,Netherlands,0,2,0.76247,0.61751,7,winner,loser
Argentina,Brazil,4,2,Copa Roca,Argentina,26,5,1960,2,-2,6,871,1,0,Argentina,Brazil,0,2,0.8163,0.56241,7,winner,loser
Argentina,Brazil,1,4,Copa Roca,Argentina,29,5,1960,-3,3,5,872,1,0,Argentina,Brazil,0,3,0.63167,0.15145,7,loser,winner
Mexico,Netherlands,3,1,Friendly,Mexico,26,6,1960,2,-2,4,873,1,1,Mexico,Netherlands,0,2,0.92642,0.85386,7,winner,loser
Uruguay,Brazil,1,0,Atlantic Cup,Uruguay,9,7,1960,1,-1,1,874,1,0,Uruguay,Brazil,0,1,0.40378,0.19957,7,winner,loser
Brazil,Argentina,5,1,Atlantic Cup,Brazil,12,7,1960,4,-4,6,875,0,1,Brazil,Argentina,0,4,0.45391,0.36148,7,winner,loser
Argentina,Spain,2,0,Friendly,Argentina,24,7,1960,2,-2,2,876,1,1,Argentina,Spain,0,2,0.3224,0.86784,7,winner,loser
Argentina,Uruguay,4,0,Atlantic Cup,Argentina,17,8,1960,4,-4,4,877,1,1,Argentina,Uruguay,0,4,0.22202,0.42993,7,winner,loser
Poland,France,2,2,Friendly,Poland,28,9,1960,0,0,4,878,0,0,Poland,France,0,0,0.53814,0.82323,7,draw,draw
Belgium,Netherlands,1,4,Friendly,Belgium,2,10,1960,-3,3,5,879,1,1,Belgium,Netherlands,0,3,0.8271,0.28903,7,loser,winner
Switzerland,France,6,2,Friendly,Switzerland,12,10,1960,4,-4,8,880,0,0,Switzerland,France,0,4,0.16758,0.96726,7,winner,loser
England,Spain,4,2,Friendly,England,26,10,1960,2,-2,6,881,1,1,England,Spain,0,2,0.08928,0.14675,7,winner,loser
Morocco,Tunisia,2,1,FIFA World Cup qualification,Morocco,30,10,1960,1,-1,3,882,0,1,Morocco,Tunisia,0,1,0.12873,0.37171,7,winner,loser
South Korea,Japan,2,1,FIFA World Cup qualification,South Korea,6,11,1960,1,-1,3,883,0,0,South_Korea,Japan,0,1,0.55076,0.54769,7,winner,loser
United States,Mexico,3,3,FIFA World Cup qualification,United States,6,11,1960,0,0,6,884,0,1,United_States,Mexico,0,0,0.65474,0.40409,7,draw,draw
Mexico,United States,3,0,FIFA World Cup qualification,Mexico,13,11,1960,3,-3,3,885,1,0,Mexico,United_States,0,3,0.9363,0.73583,7,winner,loser
Tunisia,Morocco,2,1,FIFA World Cup qualification,Tunisia,13,11,1960,1,-1,3,886,1,0,Tunisia,Morocco,0,1,0.75726,0.08763,7,winner,loser
Belgium,Switzerland,2,4,FIFA World Cup qualification,Belgium,20,11,1960,-2,2,6,887,1,0,Belgium,Switzerland,0,2,0.45137,0.12085,7,loser,winner
England,Wales,5,1,British Championship,England,23,11,1960,4,-4,6,888,1,0,England,Wales,0,4,0.25684,0.12669,7,winner,loser
Ecuador,Argentina,3,6,FIFA World Cup qualification,Ecuador,4,12,1960,-3,3,9,889,0,1,Ecuador,Argentina,0,3,0.86757,0.09971,7,loser,winner
Argentina,Ecuador,5,0,FIFA World Cup qualification,Argentina,17,12,1960,5,-5,5,890,1,0,Argentina,Ecuador,0,5,0.98052,0.90099,7,winner,loser
Morocco,Tunisia,1,1,FIFA World Cup qualification,Italy,22,2,1961,0,0,2,891,0,1,Morocco,Tunisia,1,0,0.71158,0.45633,7,draw,draw
Germany,Belgium,1,0,Friendly,Germany,8,3,1961,1,-1,1,892,1,1,Germany,Belgium,1,1,0.35137,0.22664,7,winner,loser
France,Belgium,1,1,Friendly,France,15,3,1961,0,0,2,893,0,1,France,Belgium,1,0,0.12739,0.76022,7,draw,draw
Costa Rica,Mexico,1,0,FIFA World Cup qualification,Costa Rica,22,3,1961,1,-1,1,894,1,1,Costa_Rica,Mexico,1,1,0.53662,0.48687,7,winner,loser
Netherlands,Belgium,6,2,Friendly,Netherlands,22,3,1961,4,-4,8,895,1,1,Netherlands,Belgium,1,4,0.14068,0.24026,7,winner,loser
Ghana,Morocco,0,0,FIFA World Cup qualification,Ghana,2,4,1961,0,0,0,896,0,0,Ghana,Morocco,1,0,0.14662,0.75876,7,draw,draw
Spain,France,2,0,Friendly,Spain,2,4,1961,2,-2,2,897,1,0,Spain,France,1,2,0.81645,0.29978,7,winner,loser
Mexico,Costa Rica,4,1,FIFA World Cup qualification,Mexico,12,4,1961,3,-3,5,898,1,1,Mexico,Costa_Rica,1,3,0.85179,0.38299,7,winner,loser
Netherlands,Mexico,1,2,Friendly,Netherlands,19,4,1961,-1,1,3,899,1,1,Netherlands,Mexico,1,1,0.6832,0.70849,7,loser,winner
Wales,Spain,1,2,FIFA World Cup qualification,Wales,19,4,1961,-1,1,3,900,0,1,Wales,Spain,1,1,0.32896,0.6381,7,loser,winner
England,Mexico,8,0,Friendly,England,10,5,1961,8,-8,8,901,1,1,England,Mexico,1,8,0.78711,0.89231,7,winner,loser
Spain,Wales,1,1,FIFA World Cup qualification,Spain,18,5,1961,0,0,2,902,1,0,Spain,Wales,1,0,0.21808,0.83564,7,draw,draw
Switzerland,Belgium,2,1,FIFA World Cup qualification,Switzerland,20,5,1961,1,-1,3,903,0,1,Switzerland,Belgium,1,1,0.22427,0.70027,7,winner,loser
Portugal,England,1,1,FIFA World Cup qualification,Portugal,21,5,1961,0,0,2,904,1,1,Portugal,England,1,0,0.71879,0.72222,7,draw,draw
Morocco,Ghana,1,0,FIFA World Cup qualification,Morocco,28,5,1961,1,-1,1,905,0,0,Morocco,Ghana,1,1,0.48487,0.0552,7,winner,loser
Portugal,Argentina,0,2,Friendly,Portugal,4,6,1961,-2,2,2,906,1,1,Portugal,Argentina,1,2,0.49095,0.49352,7,loser,winner
Japan,South Korea,0,2,FIFA World Cup qualification,Japan,11,6,1961,-2,2,2,907,0,0,Japan,South_Korea,1,2,0.27655,0.65218,7,loser,winner
Spain,Argentina,2,0,Friendly,Spain,11,6,1961,2,-2,2,908,1,1,Spain,Argentina,1,2,0.80893,0.82932,7,winner,loser
Germany,Denmark,5,1,Friendly,Germany,20,9,1961,4,-4,6,909,1,1,Germany,Denmark,1,4,0.34984,0.75373,7,winner,loser
Poland,Germany,0,2,Friendly,Poland,8,10,1961,-2,2,2,910,0,1,Poland,Germany,1,2,0.98857,0.88646,7,loser,winner
Wales,England,1,1,British Championship,Wales,14,10,1961,0,0,2,911,0,1,Wales,England,1,0,0.86632,0.05111,7,draw,draw
Belgium,France,3,0,Friendly,Belgium,18,10,1961,3,-3,3,912,1,0,Belgium,France,1,3,0.62437,0.08752,7,winner,loser
England,Portugal,2,0,FIFA World Cup qualification,England,25,10,1961,2,-2,2,913,1,1,England,Portugal,1,2,0.34764,0.72258,7,winner,loser
Poland,Denmark,5,0,Friendly,Poland,5,11,1961,5,-5,5,914,0,1,Poland,Denmark,1,5,0.65799,0.16276,7,winner,loser
Morocco,Spain,0,1,FIFA World Cup qualification,Morocco,12,11,1961,-1,1,1,915,0,1,Morocco,Spain,1,1,0.51023,0.96919,7,loser,winner
Netherlands,Belgium,0,4,Friendly,Netherlands,12,11,1961,-4,4,4,916,1,1,Netherlands,Belgium,1,4,0.56058,0.1607,7,loser,winner
Spain,Morocco,3,2,FIFA World Cup qualification,Spain,23,11,1961,1,-1,5,917,1,0,Spain,Morocco,1,1,0.05317,0.29305,7,winner,loser
France,Spain,1,1,Friendly,France,10,12,1961,0,0,2,918,0,1,France,Spain,1,0,0.07757,0.01654,7,draw,draw
Uruguay,Argentina,1,1,Friendly,Uruguay,13,3,1962,0,0,2,919,1,1,Uruguay,Argentina,2,0,0.71186,0.69054,7,draw,draw
Argentina,Mexico,1,0,Friendly,Argentina,28,3,1962,1,-1,1,920,1,1,Argentina,Mexico,2,1,0.79897,0.13346,7,winner,loser
Belgium,Netherlands,3,1,Friendly,Belgium,1,4,1962,2,-2,4,921,1,1,Belgium,Netherlands,2,2,0.13328,0.17852,7,winner,loser
France,Poland,1,3,Friendly,France,11,4,1962,-2,2,4,922,0,0,France,Poland,2,2,0.06138,0.52239,7,loser,winner
Germany,Uruguay,3,0,Friendly,Germany,11,4,1962,3,-3,3,923,1,1,Germany,Uruguay,2,3,0.84557,0.21911,7,winner,loser
Morocco,Poland,1,3,Friendly,Morocco,15,4,1962,-2,2,4,924,0,0,Morocco,Poland,2,2,0.94908,0.5417,7,loser,winner
Brazil,Portugal,2,1,Friendly,Brazil,6,5,1962,1,-1,3,925,0,1,Brazil,Portugal,2,1,0.36466,0.96263,7,winner,loser
Brazil,Portugal,1,0,Friendly,Brazil,9,5,1962,1,-1,1,926,0,1,Brazil,Portugal,2,1,0.47552,0.63293,7,winner,loser
England,Switzerland,3,1,Friendly,England,9,5,1962,2,-2,4,927,1,0,England,Switzerland,2,2,0.518,0.37733,7,winner,loser
Brazil,Wales,3,1,Friendly,Brazil,12,5,1962,2,-2,4,928,0,0,Brazil,Wales,2,2,0.75463,0.57982,7,winner,loser
Brazil,Wales,3,1,Friendly,Brazil,16,5,1962,2,-2,4,929,0,0,Brazil,Wales,2,2,0.97171,0.43639,7,winner,loser
Portugal,Belgium,1,2,Friendly,Portugal,17,5,1962,-1,1,3,930,1,1,Portugal,Belgium,2,1,0.14191,0.10558,7,loser,winner
Mexico,Wales,2,1,Friendly,Mexico,22,5,1962,1,-1,3,931,1,0,Mexico,Wales,2,1,0.98187,0.6384,7,winner,loser
Poland,Belgium,2,0,Friendly,Poland,23,5,1962,2,-2,2,932,0,1,Poland,Belgium,2,2,3.50E-04,0.13531,7,winner,loser
Brazil,Mexico,2,0,FIFA World Cup,Chile,30,5,1962,2,-2,2,933,0,1,Brazil,Mexico,2,2,0.44682,0.3866,7,winner,loser
Argentina,England,1,3,FIFA World Cup,Chile,2,6,1962,-2,2,4,934,1,1,Argentina,England,2,2,0.51862,0.08806,7,loser,winner
Germany,Switzerland,2,1,FIFA World Cup,Chile,3,6,1962,1,-1,3,935,1,0,Germany,Switzerland,2,1,0.58792,0.71402,7,winner,loser
Mexico,Spain,0,1,FIFA World Cup,Chile,3,6,1962,-1,1,1,936,1,1,Mexico,Spain,2,1,0.71291,0.09517,7,loser,winner
Brazil,Spain,2,1,FIFA World Cup,Chile,6,6,1962,1,-1,3,937,0,1,Brazil,Spain,2,1,0.84466,0.42934,7,winner,loser
Brazil,England,3,1,FIFA World Cup,Chile,10,6,1962,2,-2,4,938,0,1,Brazil,England,2,2,0.68528,0.05126,7,winner,loser
Argentina,Uruguay,3,1,Copa Lipton,Argentina,15,8,1962,2,-2,4,939,1,1,Argentina,Uruguay,2,2,0.24191,0.92828,7,winner,loser
Denmark,Netherlands,4,1,Friendly,Denmark,26,9,1962,3,-3,5,940,1,1,Denmark,Netherlands,2,3,0.06388,0.72017,7,winner,loser
England,France,1,1,UEFA Euro qualification,England,3,10,1962,0,0,2,941,1,0,England,France,2,0,0.91822,0.43966,7,draw,draw
Poland,Morocco,1,1,Friendly,Poland,11,10,1962,0,0,2,942,0,0,Poland,Morocco,2,0,0.08917,0.87768,7,draw,draw
Belgium,Netherlands,2,0,Friendly,Belgium,14,10,1962,2,-2,2,943,1,1,Belgium,Netherlands,2,2,0.12713,0.3475,7,winner,loser
Germany,France,2,2,Friendly,Germany,24,10,1962,0,0,4,944,1,0,Germany,France,2,0,0.81006,0.72281,7,draw,draw
Netherlands,Switzerland,3,1,UEFA Euro qualification,Netherlands,11,11,1962,2,-2,4,945,1,0,Netherlands,Switzerland,2,2,0.10868,0.16284,7,winner,loser
England,Wales,4,0,British Championship,England,21,11,1962,4,-4,4,946,1,0,England,Wales,2,4,0.16078,0.18287,7,winner,loser
Belgium,Spain,1,1,Friendly,Belgium,2,12,1962,0,0,2,947,1,1,Belgium,Spain,2,0,0.60848,0.25428,7,draw,draw
Germany,Switzerland,5,1,Friendly,Germany,23,12,1962,4,-4,6,948,1,0,Germany,Switzerland,2,4,0.82785,0.07395,7,winner,loser
Spain,France,0,0,Friendly,Spain,9,1,1963,0,0,0,949,1,0,Spain,France,3,0,0.50186,0.95431,7,draw,draw
Morocco,Switzerland,1,0,Friendly,Morocco,13,1,1963,1,-1,1,950,0,0,Morocco,Switzerland,3,1,0.79015,0.35483,7,winner,loser
France,England,5,2,UEFA Euro qualification,France,27,2,1963,3,-3,7,951,0,1,France,England,3,3,0.52631,0.9816,7,winner,loser
Netherlands,Belgium,0,1,Friendly,Netherlands,3,3,1963,-1,1,1,952,1,1,Netherlands,Belgium,3,1,0.62638,0.09945,7,loser,winner
Argentina,Ecuador,4,2,Copa America,Bolivia,20,3,1963,2,-2,6,953,1,0,Argentina,Ecuador,3,2,0.82397,0.21111,7,winner,loser
Argentina,Brazil,3,0,Copa America,Bolivia,24,3,1963,3,-3,3,954,1,0,Argentina,Brazil,3,3,0.24106,0.90553,7,winner,loser
Brazil,Ecuador,2,2,Copa America,Bolivia,27,3,1963,0,0,4,955,0,0,Brazil,Ecuador,3,0,0.99892,0.6718,7,draw,draw
Costa Rica,Mexico,0,0,CONCACAF Championship,El Salvador,30,3,1963,0,0,0,956,1,1,Costa_Rica,Mexico,3,0,0.73208,0.56172,7,draw,draw
Switzerland,Netherlands,1,1,UEFA Euro qualification,Switzerland,31,3,1963,0,0,2,957,0,1,Switzerland,Netherlands,3,0,0.84161,0.42699,7,draw,draw
Brazil,Argentina,2,3,Copa Roca,Brazil,13,4,1963,-1,1,5,958,0,1,Brazil,Argentina,3,1,0.96906,0.57585,7,loser,winner
Brazil,Argentina,5,2,Copa Roca,Brazil,16,4,1963,3,-3,7,959,0,1,Brazil,Argentina,3,3,0.64434,0.86309,7,winner,loser
Netherlands,France,1,0,Friendly,Netherlands,17,4,1963,1,-1,1,960,1,0,Netherlands,France,3,1,0.52685,0.73573,7,winner,loser
Portugal,Brazil,1,0,Friendly,Portugal,21,4,1963,1,-1,1,961,1,0,Portugal,Brazil,3,1,0.18114,0.55783,7,winner,loser
Belgium,Brazil,5,1,Friendly,Belgium,24,4,1963,4,-4,6,962,1,0,Belgium,Brazil,3,4,0.52431,0.79461,7,winner,loser
France,Brazil,2,3,Friendly,France,28,4,1963,-1,1,5,963,0,0,France,Brazil,3,1,0.13858,0.15043,7,loser,winner
Netherlands,Brazil,1,0,Friendly,Netherlands,2,5,1963,1,-1,1,964,1,0,Netherlands,Brazil,3,1,0.87445,0.95049,7,winner,loser
Germany,Brazil,1,2,Friendly,Germany,5,5,1963,-1,1,3,965,1,0,Germany,Brazil,3,1,0.03905,0.08095,7,loser,winner
England,Brazil,1,1,Friendly,England,8,5,1963,0,0,2,966,1,0,England,Brazil,3,0,0.01252,0.20192,7,draw,draw
Switzerland,England,1,8,Friendly,Switzerland,5,6,1963,-7,7,9,967,0,1,Switzerland,England,3,7,0.99019,0.00246,7,loser,winner
Morocco,Tunisia,4,2,African Cup of Nations qualification,Morocco,2,7,1963,2,-2,6,968,0,1,Morocco,Tunisia,3,2,0.73248,0.60009,7,winner,loser
South Korea,Japan,1,1,Merdeka Tournament,Malaya,13,8,1963,0,0,2,969,0,0,South_Korea,Japan,3,0,0.46529,0.48458,7,draw,draw
Wales,England,0,4,British Championship,Wales,12,10,1963,-4,4,4,970,0,1,Wales,England,3,4,0.03055,0.00381,7,loser,winner
Netherlands,Belgium,1,1,Friendly,Netherlands,20,10,1963,0,0,2,971,1,1,Netherlands,Belgium,3,0,0.02456,0.22903,7,draw,draw
France,Switzerland,2,2,Friendly,France,11,11,1963,0,0,4,972,0,0,France,Switzerland,3,0,0.2632,0.83208,7,draw,draw
Ghana,Tunisia,1,1,African Cup of Nations,Ghana,24,11,1963,0,0,2,973,0,1,Ghana,Tunisia,3,0,0.14602,0.43058,7,draw,draw
Spain,Belgium,1,2,Friendly,Spain,1,12,1963,-1,1,3,974,1,1,Spain,Belgium,3,1,0.47605,0.05614,7,loser,winner
France,Belgium,1,2,Friendly,France,25,12,1963,-1,1,3,975,0,1,France,Belgium,3,1,0.55367,0.93096,7,loser,winner
Morocco,Germany,1,4,Friendly,Morocco,29,12,1963,-3,3,5,976,0,1,Morocco,Germany,3,3,0.92188,0.61855,7,loser,winner
Belgium,Netherlands,0,0,Friendly,Belgium,22,3,1964,0,0,0,977,1,1,Belgium,Netherlands,4,0,0.72035,0.5068,7,draw,draw
Switzerland,Belgium,2,0,Friendly,Switzerland,15,4,1964,2,-2,2,978,0,1,Switzerland,Belgium,4,2,0.86177,0.75917,7,winner,loser
Switzerland,Portugal,2,3,Friendly,Switzerland,29,4,1964,-1,1,5,979,0,1,Switzerland,Portugal,4,1,0.19543,0.66709,7,loser,winner
Belgium,Portugal,1,2,Friendly,Belgium,3,5,1964,-1,1,3,980,1,1,Belgium,Portugal,4,1,0.73602,0.74668,7,loser,winner
England,Uruguay,2,1,Friendly,England,6,5,1964,1,-1,3,981,1,1,England,Uruguay,4,1,0.31645,0.46021,7,winner,loser
Portugal,England,3,4,Friendly,Portugal,17,5,1964,-1,1,7,982,1,1,Portugal,England,4,1,0.15056,0.81649,7,loser,winner
United States,England,0,10,Friendly,United States,27,5,1964,-10,10,10,983,0,1,United_States,England,4,10,0.64096,0.48997,7,loser,winner
Brazil,England,5,1,Friendly,Brazil,30,5,1964,4,-4,6,984,0,1,Brazil,England,4,4,0.24279,0.36925,7,winner,loser
Argentina,Portugal,2,0,Friendly,Brazil,31,5,1964,2,-2,2,985,1,1,Argentina,Portugal,4,2,0.10222,0.78257,7,winner,loser
Brazil,Argentina,0,3,Friendly,Brazil,3,6,1964,-3,3,3,986,0,1,Brazil,Argentina,4,3,0.24427,0.23265,7,loser,winner
England,Portugal,1,1,Friendly,Brazil,4,6,1964,0,0,2,987,1,1,England,Portugal,4,0,0.74096,0.67883,7,draw,draw
Argentina,England,1,0,Friendly,Brazil,6,6,1964,1,-1,1,988,1,1,Argentina,England,4,1,0.42932,0.61188,7,winner,loser
Brazil,Portugal,4,1,Friendly,Brazil,7,6,1964,3,-3,5,989,0,1,Brazil,Portugal,4,3,0.49931,0.28045,7,winner,loser
Belgium,Netherlands,1,0,Friendly,Belgium,30,9,1964,1,-1,1,990,1,1,Belgium,Netherlands,4,1,0.85143,0.03407,7,winner,loser
Denmark,Wales,1,0,FIFA World Cup qualification,Denmark,21,10,1964,1,-1,1,991,1,0,Denmark,Wales,4,1,0.90463,0.05663,7,winner,loser
England,Belgium,2,2,Friendly,England,21,10,1964,0,0,4,992,1,1,England,Belgium,4,0,0.38876,0.35851,7,draw,draw
Portugal,Spain,2,1,Friendly,Portugal,15,11,1964,1,-1,3,993,1,1,Portugal,Spain,4,1,0.85617,0.76073,7,winner,loser
England,Wales,2,1,British Championship,England,18,11,1964,1,-1,3,994,1,0,England,Wales,4,1,0.90996,0.10969,7,winner,loser
Belgium,France,3,0,Friendly,Belgium,2,12,1964,3,-3,3,995,1,0,Belgium,France,4,3,0.98461,0.11125,7,winner,loser
Netherlands,England,1,1,Friendly,Netherlands,9,12,1964,0,0,2,996,1,1,Netherlands,England,4,0,0.85829,0.47979,7,draw,draw
Tunisia,Morocco,0,0,Friendly,Tunisia,28,2,1965,0,0,0,997,1,0,Tunisia,Morocco,5,0,0.88915,0.1852,7,draw,draw
United States,Mexico,2,2,FIFA World Cup qualification,United States,7,3,1965,0,0,4,998,0,1,United_States,Mexico,5,0,0.76669,0.97934,7,draw,draw
Mexico,United States,2,0,FIFA World Cup qualification,Mexico,12,3,1965,2,-2,2,999,1,0,Mexico,United_States,5,2,0.52118,0.10708,7,winner,loser
Costa Rica,Mexico,1,1,CONCACAF Championship,Guatemala,6,4,1965,0,0,2,1000,1,1,Costa_Rica,Mexico,5,0,0.08724,0.87938,7,draw,draw
Belgium,Poland,0,0,Friendly,Belgium,7,4,1965,0,0,0,1001,1,0,Belgium,Poland,5,0,0.4478,0.55674,7,draw,draw
Costa Rica,Mexico,0,0,FIFA World Cup qualification,Costa Rica,25,4,1965,0,0,0,1002,1,1,Costa_Rica,Mexico,5,0,0.4459,0.17811,7,draw,draw
Morocco,Tunisia,0,1,Friendly,Morocco,2,5,1965,-1,1,1,1003,0,1,Morocco,Tunisia,5,1,0.36285,0.4371,7,loser,winner
Germany,England,0,1,Friendly,Germany,12,5,1965,-1,1,1,1004,1,1,Germany,England,5,1,0.61269,0.51089,7,loser,winner
Mexico,Costa Rica,1,0,FIFA World Cup qualification,Mexico,16,5,1965,1,-1,1,1005,1,1,Mexico,Costa_Rica,5,1,0.30122,0.9158,7,winner,loser
Switzerland,Germany,0,1,Friendly,Switzerland,26,5,1965,-1,1,1,1006,0,1,Switzerland,Germany,5,1,0.64331,0.31405,7,loser,winner
Brazil,Belgium,5,0,Friendly,Brazil,2,6,1965,5,-5,5,1007,0,1,Brazil,Belgium,5,5,0.53439,0.29286,7,winner,loser
France,Argentina,0,0,Friendly,France,3,6,1965,0,0,0,1008,0,1,France,Argentina,5,0,0.47561,0.32347,7,draw,draw
Brazil,Germany,2,0,Friendly,Brazil,6,6,1965,2,-2,2,1009,0,1,Brazil,Germany,5,2,0.54398,0.48025,7,winner,loser
Brazil,Argentina,0,0,Friendly,Brazil,9,6,1965,0,0,0,1010,0,1,Brazil,Argentina,5,0,0.43496,0.7015,7,draw,draw
Portugal,Brazil,0,0,Friendly,Portugal,24,6,1965,0,0,0,1011,1,0,Portugal,Brazil,5,0,0.02679,0.76165,7,draw,draw
Brazil,Uruguay,3,0,Friendly,Brazil,7,9,1965,3,-3,3,1012,0,1,Brazil,Uruguay,5,3,0.2728,0.48604,7,winner,loser
Wales,England,0,0,British Championship,Wales,2,10,1965,0,0,0,1013,0,1,Wales,England,5,0,0.04713,0.90034,7,draw,draw
Netherlands,Switzerland,0,0,FIFA World Cup qualification,Netherlands,17,10,1965,0,0,0,1014,1,0,Netherlands,Switzerland,5,0,0.27726,0.89042,7,draw,draw
Switzerland,Netherlands,2,1,FIFA World Cup qualification,Switzerland,14,11,1965,1,-1,3,1015,0,1,Switzerland,Netherlands,5,1,0.13903,0.78731,7,winner,loser
Tunisia,Senegal,0,0,African Cup of Nations,Tunisia,14,11,1965,0,0,0,1016,1,0,Tunisia,Senegal,5,0,0.06753,0.18625,7,draw,draw
Tunisia,Ghana,2,3,African Cup of Nations,Tunisia,21,11,1965,-1,1,5,1017,1,0,Tunisia,Ghana,5,1,0.34392,0.12545,7,loser,winner
Wales,Denmark,4,2,FIFA World Cup qualification,Wales,1,12,1965,2,-2,6,1018,0,1,Wales,Denmark,5,2,0.63752,0.65892,7,winner,loser
Spain,England,0,2,Friendly,Spain,8,12,1965,-2,2,2,1019,1,1,Spain,England,5,2,0.25092,0.4911,7,loser,winner
England,Poland,1,1,Friendly,England,5,1,1966,0,0,2,1020,1,0,England,Poland,6,0,0.15962,0.69276,7,draw,draw
England,Germany,1,0,Friendly,England,23,2,1966,1,-1,1,1021,1,1,England,Germany,6,1,0.77042,0.10804,7,winner,loser
Netherlands,Germany,2,4,Friendly,Netherlands,23,3,1966,-2,2,6,1022,1,1,Netherlands,Germany,6,2,0.04208,0.94237,7,loser,winner
Netherlands,Belgium,3,1,Friendly,Netherlands,17,4,1966,2,-2,4,1023,1,1,Netherlands,Belgium,6,2,0.45087,0.67145,7,winner,loser
France,Belgium,0,3,Friendly,France,20,4,1966,-3,3,3,1024,0,1,France,Belgium,6,3,0.38438,0.01436,7,loser,winner
Brazil,Wales,3,1,Friendly,Brazil,14,5,1966,2,-2,4,1025,0,0,Brazil,Wales,6,2,0.61639,0.23214,7,winner,loser
Brazil,Wales,1,0,Friendly,Brazil,18,5,1966,1,-1,1,1026,0,0,Brazil,Wales,6,1,0.39905,0.60876,7,winner,loser
Brazil,Poland,4,1,Friendly,Brazil,5,6,1966,3,-3,5,1027,0,0,Brazil,Poland,6,3,0.3763,0.19277,7,winner,loser
Brazil,Poland,2,1,Friendly,Brazil,8,6,1966,1,-1,3,1028,0,0,Brazil,Poland,6,1,0.41204,0.25758,7,winner,loser
Argentina,Poland,1,1,Friendly,Argentina,11,6,1966,0,0,2,1029,1,0,Argentina,Poland,6,0,0.79045,0.75446,7,draw,draw
Switzerland,Mexico,1,1,Friendly,Switzerland,19,6,1966,0,0,2,1030,0,1,Switzerland,Mexico,6,0,0.07448,0.46128,7,draw,draw
Denmark,Portugal,1,3,Friendly,Denmark,21,6,1966,-2,2,4,1031,1,1,Denmark,Portugal,6,2,0.90279,0.31512,7,loser,winner
Spain,Uruguay,1,1,Friendly,Spain,23,6,1966,0,0,2,1032,1,1,Spain,Uruguay,6,0,0.95671,0.45032,7,draw,draw
Portugal,Uruguay,3,0,Friendly,Portugal,26,6,1966,3,-3,3,1033,1,1,Portugal,Uruguay,6,3,0.20418,0.06474,7,winner,loser
Denmark,England,0,2,Friendly,Denmark,3,7,1966,-2,2,2,1034,1,1,Denmark,England,6,2,0.76387,0.30775,7,loser,winner
Poland,England,0,1,Friendly,Poland,5,7,1966,-1,1,1,1035,0,1,Poland,England,6,1,0.85144,0.21508,7,loser,winner
England,Uruguay,0,0,FIFA World Cup,England,11,7,1966,0,0,0,1036,1,1,England,Uruguay,6,0,0.82386,0.13028,7,draw,draw
Germany,Switzerland,5,0,FIFA World Cup,England,12,7,1966,5,-5,5,1037,1,0,Germany,Switzerland,6,5,0.88917,0.65456,7,winner,loser
Argentina,Spain,2,1,FIFA World Cup,England,13,7,1966,1,-1,3,1038,1,1,Argentina,Spain,6,1,0.64338,0.08031,7,winner,loser
France,Mexico,1,1,FIFA World Cup,England,13,7,1966,0,0,2,1039,0,1,France,Mexico,6,0,0.24011,0.46681,7,draw,draw
France,Uruguay,1,2,FIFA World Cup,England,15,7,1966,-1,1,3,1040,0,1,France,Uruguay,6,1,0.54091,0.21081,7,loser,winner
Spain,Switzerland,2,1,FIFA World Cup,England,15,7,1966,1,-1,3,1041,1,0,Spain,Switzerland,6,1,0.07987,0.5416,7,winner,loser
Argentina,Germany,0,0,FIFA World Cup,England,16,7,1966,0,0,0,1042,1,1,Argentina,Germany,6,0,0.87061,0.90497,7,draw,draw
England,Mexico,2,0,FIFA World Cup,England,16,7,1966,2,-2,2,1043,1,1,England,Mexico,6,2,0.78113,0.56594,7,winner,loser
Argentina,Switzerland,2,0,FIFA World Cup,England,19,7,1966,2,-2,2,1044,1,0,Argentina,Switzerland,6,2,0.96833,0.99107,7,winner,loser
Brazil,Portugal,1,3,FIFA World Cup,England,19,7,1966,-2,2,4,1045,0,1,Brazil,Portugal,6,2,0.15405,0.27904,7,loser,winner
Mexico,Uruguay,0,0,FIFA World Cup,England,19,7,1966,0,0,0,1046,1,1,Mexico,Uruguay,6,0,0.53528,0.99682,7,draw,draw
England,France,2,0,FIFA World Cup,England,20,7,1966,2,-2,2,1047,1,0,England,France,6,2,0.87174,0.13545,7,winner,loser
Germany,Spain,2,1,FIFA World Cup,England,20,7,1966,1,-1,3,1048,1,1,Germany,Spain,6,1,0.01987,0.41575,7,winner,loser
England,Argentina,1,0,FIFA World Cup,England,23,7,1966,1,-1,1,1049,1,1,England,Argentina,6,1,0.40253,0.34975,7,winner,loser
Germany,Uruguay,4,0,FIFA World Cup,England,23,7,1966,4,-4,4,1050,1,1,Germany,Uruguay,6,4,0.09409,0.34214,7,winner,loser
England,Portugal,2,1,FIFA World Cup,England,26,7,1966,1,-1,3,1051,1,1,England,Portugal,6,1,0.50434,0.79149,7,winner,loser
England,Germany,4,2,FIFA World Cup,England,30,7,1966,2,-2,6,1052,1,1,England,Germany,6,2,0.3988,0.72212,7,winner,loser
South Korea,Japan,2,0,Merdeka Tournament,Malaysia,14,8,1966,2,-2,2,1053,0,0,South_Korea,Japan,6,2,0.78525,0.76999,7,winner,loser
Belgium,Switzerland,1,0,Friendly,Belgium,22,10,1966,1,-1,1,1054,1,0,Belgium,Switzerland,6,1,0.9301,0.94037,7,winner,loser
France,Poland,2,1,UEFA Euro qualification,France,22,10,1966,1,-1,3,1055,0,0,France,Poland,6,1,0.88079,0.20586,7,winner,loser
Belgium,France,2,1,UEFA Euro qualification,Belgium,11,11,1966,1,-1,3,1056,1,0,Belgium,France,6,1,0.99615,0.43567,7,winner,loser
England,Wales,5,1,UEFA Euro qualification,England,16,11,1966,4,-4,6,1057,1,0,England,Wales,6,4,0.87039,0.68987,7,winner,loser
Netherlands,Denmark,2,0,UEFA Euro qualification,Netherlands,30,11,1966,2,-2,2,1058,1,1,Netherlands,Denmark,6,2,0.43983,0.67495,7,winner,loser
Mexico,Switzerland,3,0,Friendly,Mexico,5,1,1967,3,-3,3,1059,1,0,Mexico,Switzerland,7,3,0.72963,0.91105,7,winner,loser
Mexico,Switzerland,0,2,Friendly,Mexico,8,1,1967,-2,2,2,1060,1,0,Mexico,Switzerland,7,2,0.19275,0.76513,7,loser,winner
Uruguay,Argentina,1,0,Copa America,Uruguay,2,2,1967,1,-1,1,1061,1,1,Uruguay,Argentina,7,1,0.93359,0.39699,7,winner,loser
Tunisia,Cameroon,4,0,African Cup of Nations qualification,Tunisia,5,2,1967,4,-4,4,1062,1,1,Tunisia,Cameroon,7,4,0.64768,0.01626,7,winner,loser
Germany,Morocco,5,1,Friendly,Germany,22,2,1967,4,-4,6,1063,1,0,Germany,Morocco,7,4,0.5327,0.79424,7,winner,loser
Belgium,Netherlands,1,0,Friendly,Belgium,16,4,1967,1,-1,1,1064,1,1,Belgium,Netherlands,7,1,0.78964,0.88622,7,winner,loser
Poland,Belgium,3,1,UEFA Euro qualification,Poland,21,5,1967,2,-2,4,1065,0,1,Poland,Belgium,7,2,0.20369,0.9989,7,winner,loser
England,Spain,2,0,Friendly,England,24,5,1967,2,-2,2,1066,1,1,England,Spain,7,2,0.2555,0.71726,7,winner,loser
Uruguay,Brazil,0,0,Copa Rio Branco,Uruguay,25,6,1967,0,0,0,1067,1,0,Uruguay,Brazil,7,0,0.39934,0.50834,7,draw,draw
Uruguay,Brazil,2,2,Copa Rio Branco,Uruguay,28,6,1967,0,0,4,1068,1,0,Uruguay,Brazil,7,0,0.28983,0.73111,7,draw,draw
Uruguay,Brazil,1,1,Copa Rio Branco,Uruguay,1,7,1967,0,0,2,1069,1,0,Uruguay,Brazil,7,0,0.66979,0.86264,7,draw,draw
Japan,South Korea,2,1,AFC Asian Cup qualification,Taiwan,1,8,1967,1,-1,3,1070,0,0,Japan,South_Korea,7,1,0.57527,0.67928,7,winner,loser
Mexico,Argentina,2,1,Friendly,Mexico,22,8,1967,1,-1,3,1071,1,1,Mexico,Argentina,7,1,0.2332,0.19873,7,winner,loser
Poland,France,1,4,UEFA Euro qualification,Poland,17,9,1967,-3,3,5,1072,0,0,Poland,France,7,3,0.69935,0.526,7,loser,winner
Germany,France,5,1,Friendly,Germany,27,9,1967,4,-4,6,1073,1,0,Germany,France,7,4,0.44518,0.67072,7,winner,loser
Denmark,Netherlands,3,2,UEFA Euro qualification,Denmark,4,10,1967,1,-1,5,1074,1,1,Denmark,Netherlands,7,1,0.96958,0.20568,7,winner,loser
Belgium,Poland,2,4,UEFA Euro qualification,Belgium,8,10,1967,-2,2,6,1075,1,0,Belgium,Poland,7,2,0.30652,0.25803,7,loser,winner
Wales,England,0,3,UEFA Euro qualification,Wales,21,10,1967,-3,3,3,1076,0,1,Wales,England,7,3,0.02368,0.70031,7,loser,winner
France,Belgium,1,1,UEFA Euro qualification,France,28,10,1967,0,0,2,1077,0,1,France,Belgium,7,0,0.63392,0.33315,7,draw,draw
Australia,South Korea,3,2,Vietnam Independence Cup,Vietnam Republic,14,11,1967,1,-1,5,1078,0,0,Australia,South_Korea,7,1,0.74048,0.25113,7,winner,loser
Saudi Arabia,Tunisia,4,0,Friendly,Saudi Arabia,10,12,1967,4,-4,4,1079,1,1,Saudi_Arabia,Tunisia,7,4,0.76054,0.46284,7,winner,loser
Ghana,Senegal,2,2,African Cup of Nations,Ethiopia,12,1,1968,0,0,4,1080,0,0,Ghana,Senegal,8,0,0.93207,0.39002,7,draw,draw
Belgium,Germany,1,3,Friendly,Belgium,6,3,1968,-2,2,4,1081,1,1,Belgium,Germany,8,2,0.32141,0.68223,7,loser,winner
Mexico,Japan,4,0,Friendly,Mexico,26,3,1968,4,-4,4,1082,1,0,Mexico,Japan,8,4,0.61366,0.0627,7,winner,loser
Australia,Japan,2,2,Friendly,Australia,30,3,1968,0,0,4,1083,0,0,Australia,Japan,8,0,0.9129,0.61975,7,draw,draw
Australia,Japan,3,1,Friendly,Australia,31,3,1968,2,-2,4,1084,0,0,Australia,Japan,8,2,0.07493,0.15639,7,winner,loser
England,Spain,1,0,UEFA Euro qualification,England,3,4,1968,1,-1,1,1085,1,1,England,Spain,8,1,0.26989,0.90288,7,winner,loser
Australia,Japan,1,3,Friendly,Australia,4,4,1968,-2,2,4,1086,0,0,Australia,Japan,8,2,0.98841,0.51631,7,loser,winner
Netherlands,Belgium,1,2,Friendly,Netherlands,7,4,1968,-1,1,3,1087,1,1,Netherlands,Belgium,8,1,0.09771,0.54214,7,loser,winner
Switzerland,Germany,0,0,Friendly,Switzerland,17,4,1968,0,0,0,1088,0,1,Switzerland,Germany,8,0,0.50851,0.77681,7,draw,draw
Poland,Netherlands,0,0,Friendly,Poland,1,5,1968,0,0,0,1089,0,1,Poland,Netherlands,8,0,0.9861,0.44747,7,draw,draw
Spain,England,1,2,UEFA Euro qualification,Spain,8,5,1968,-1,1,3,1090,1,1,Spain,England,8,1,0.83084,0.33797,7,loser,winner
Wales,Germany,1,1,Friendly,Wales,8,5,1968,0,0,2,1091,0,1,Wales,Germany,8,0,0.70873,0.2909,7,draw,draw
Mexico,Uruguay,3,3,Friendly,Mexico,21,5,1968,0,0,6,1092,1,1,Mexico,Uruguay,8,0,0.43427,0.42211,7,draw,draw
Mexico,Uruguay,2,2,Friendly,Mexico,28,5,1968,0,0,4,1093,1,1,Mexico,Uruguay,8,0,0.80765,0.27694,7,draw,draw
Germany,England,1,0,Friendly,Germany,1,6,1968,1,-1,1,1094,1,1,Germany,England,8,1,0.78484,0.20115,7,winner,loser
Argentina,Uruguay,2,0,Copa Lipton,Argentina,5,6,1968,2,-2,2,1095,1,1,Argentina,Uruguay,8,2,0.97081,0.18978,7,winner,loser
Brazil,Uruguay,2,0,Copa Rio Branco,Brazil,9,6,1968,2,-2,2,1096,0,1,Brazil,Uruguay,8,2,0.35264,0.2983,7,winner,loser
Brazil,Uruguay,4,0,Copa Rio Branco,Brazil,12,6,1968,4,-4,4,1097,0,1,Brazil,Uruguay,8,4,0.55634,0.58562,7,winner,loser
Germany,Brazil,2,1,Friendly,Germany,16,6,1968,1,-1,3,1098,1,0,Germany,Brazil,8,1,0.32516,0.77426,7,winner,loser
Poland,Brazil,3,6,Friendly,Poland,20,6,1968,-3,3,9,1099,0,0,Poland,Brazil,8,3,0.61487,0.94936,7,loser,winner
Uruguay,Argentina,2,1,Copa Newton,Uruguay,20,6,1968,1,-1,3,1100,1,1,Uruguay,Argentina,8,1,0.12677,0.55566,7,winner,loser
Portugal,Brazil,0,2,Friendly,Mozambique,30,6,1968,-2,2,2,1101,1,0,Portugal,Brazil,8,2,0.85018,0.65685,7,loser,winner
Mexico,Brazil,0,2,Friendly,Mexico,7,7,1968,-2,2,2,1102,1,0,Mexico,Brazil,8,2,0.08576,0.97635,7,loser,winner
Mexico,Brazil,2,1,Friendly,Mexico,10,7,1968,1,-1,3,1103,1,0,Mexico,Brazil,8,1,0.30594,0.44686,7,winner,loser
Brazil,Argentina,4,1,Friendly,Brazil,7,8,1968,3,-3,5,1104,0,1,Brazil,Argentina,8,3,0.53385,0.81824,7,winner,loser
Brazil,Argentina,3,2,Friendly,Brazil,11,8,1968,1,-1,5,1105,0,1,Brazil,Argentina,8,1,0.4259,0.9561,7,winner,loser
France,Germany,1,1,Friendly,France,25,9,1968,0,0,2,1106,0,1,France,Germany,8,0,0.24452,0.80108,7,draw,draw
Canada,United States,4,2,FIFA World Cup qualification,Canada,13,10,1968,2,-2,6,1107,0,0,Canada,United_States,8,2,0.08225,0.46738,7,winner,loser
France,Spain,1,3,Friendly,France,17,10,1968,-2,2,4,1108,0,1,France,Spain,8,2,0.43121,0.44774,7,loser,winner
Uruguay,Mexico,0,2,Friendly,Uruguay,26,10,1968,-2,2,2,1109,1,1,Uruguay,Mexico,8,2,0.10356,0.96253,7,loser,winner
Brazil,Mexico,1,2,Friendly,Brazil,31,10,1968,-1,1,3,1110,0,1,Brazil,Mexico,8,1,0.8915,0.72741,7,loser,winner
United States,Canada,1,0,FIFA World Cup qualification,United States,3,11,1968,1,-1,1,1111,0,0,United_States,Canada,8,1,0.45861,0.34862,7,winner,loser
Brazil,Mexico,2,1,Friendly,Brazil,3,11,1968,1,-1,3,1112,0,1,Brazil,Mexico,8,1,0.91443,0.12139,7,winner,loser
Morocco,Senegal,1,0,FIFA World Cup qualification,Morocco,3,11,1968,1,-1,1,1113,0,0,Morocco,Senegal,8,1,0.3281,0.76015,7,winner,loser
Cameroon,Tunisia,4,2,Friendly,Cameroon,1,12,1968,2,-2,6,1114,1,1,Cameroon,Tunisia,8,2,0.58375,0.26382,7,winner,loser
Ghana,Senegal,2,0,Friendly,Ghana,1,12,1968,2,-2,2,1115,0,0,Ghana,Senegal,8,2,0.86362,0.5907,7,winner,loser
Spain,Belgium,1,1,FIFA World Cup qualification,Spain,11,12,1968,0,0,2,1116,1,1,Spain,Belgium,8,0,0.74507,0.22706,7,draw,draw
Brazil,Germany,2,2,Friendly,Brazil,14,12,1968,0,0,4,1117,0,1,Brazil,Germany,8,0,0.91649,0.78348,7,draw,draw
Argentina,Poland,1,0,Friendly,Argentina,17,12,1968,1,-1,1,1118,1,0,Argentina,Poland,8,1,0.84753,0.25815,7,winner,loser
Mexico,Germany,0,0,Friendly,Mexico,22,12,1968,0,0,0,1119,1,1,Mexico,Germany,8,0,0.69654,0.27655,7,draw,draw
Senegal,Morocco,2,1,FIFA World Cup qualification,Senegal,5,1,1969,1,-1,3,1120,0,0,Senegal,Morocco,9,1,0.44983,0.61974,7,winner,loser
Mexico,Denmark,3,0,Friendly,Mexico,22,1,1969,3,-3,3,1121,1,1,Mexico,Denmark,9,3,0.35341,0.75586,7,winner,loser
Senegal,Cameroon,3,2,Friendly,Senegal,24,1,1969,1,-1,5,1122,0,1,Senegal,Cameroon,9,1,0.4225,0.00434,7,winner,loser
Morocco,Senegal,2,0,FIFA World Cup qualification,Spain,13,2,1969,2,-2,2,1123,0,0,Morocco,Senegal,9,2,0.26175,0.69562,7,winner,loser
Belgium,Spain,2,1,FIFA World Cup qualification,Belgium,23,2,1969,1,-1,3,1124,1,1,Belgium,Spain,9,1,0.57857,0.17393,7,winner,loser
England,France,5,0,Friendly,England,12,3,1969,5,-5,5,1125,1,0,England,France,9,5,0.13008,0.39495,7,winner,loser
Germany,Wales,1,1,Friendly,Germany,26,3,1969,0,0,2,1126,1,0,Germany,Wales,9,0,0.79,0.89405,7,draw,draw
Spain,Switzerland,1,0,Friendly,Spain,26,3,1969,1,-1,1,1127,1,0,Spain,Switzerland,9,1,0.59441,0.60561,7,winner,loser
Portugal,Mexico,0,0,Friendly,Portugal,6,4,1969,0,0,0,1128,1,1,Portugal,Mexico,9,0,0.34077,0.92811,7,draw,draw
Belgium,Mexico,2,0,Friendly,Belgium,16,4,1969,2,-2,2,1129,1,1,Belgium,Mexico,9,2,0.47287,0.17914,7,winner,loser
Portugal,Switzerland,0,2,FIFA World Cup qualification,Portugal,16,4,1969,-2,2,2,1130,1,0,Portugal,Switzerland,9,2,0.87347,0.65096,7,loser,winner
Spain,Mexico,0,0,Friendly,Spain,23,4,1969,0,0,0,1131,1,1,Spain,Mexico,9,0,0.97604,0.43593,7,draw,draw
Tunisia,Morocco,0,0,FIFA World Cup qualification,Tunisia,27,4,1969,0,0,0,1132,1,0,Tunisia,Morocco,9,0,0.45828,0.30802,7,draw,draw
Denmark,Mexico,3,1,Friendly,Denmark,6,5,1969,2,-2,4,1133,1,1,Denmark,Mexico,9,2,0.09559,0.9795,7,winner,loser
England,Wales,2,1,British Championship,England,7,5,1969,1,-1,3,1134,1,0,England,Wales,9,1,0.05831,0.02187,7,winner,loser
Netherlands,Poland,1,0,FIFA World Cup qualification,Netherlands,7,5,1969,1,-1,1,1135,1,0,Netherlands,Poland,9,1,0.24844,0.3666,7,winner,loser
Morocco,Tunisia,0,0,FIFA World Cup qualification,Morocco,18,5,1969,0,0,0,1136,0,1,Morocco,Tunisia,9,0,0.77504,0.7876,7,draw,draw
Mexico,England,0,0,Friendly,Mexico,1,6,1969,0,0,0,1137,1,1,Mexico,England,9,0,0.73322,0.33313,7,draw,draw
Mexico,England,0,4,Friendly,Mexico,3,6,1969,-4,4,4,1138,1,1,Mexico,England,9,4,0.89468,0.80135,7,loser,winner
Uruguay,England,1,2,Friendly,Uruguay,8,6,1969,-1,1,3,1139,1,1,Uruguay,England,9,1,0.42411,0.85284,7,loser,winner
Brazil,England,2,1,Friendly,Brazil,12,6,1969,1,-1,3,1140,0,1,Brazil,England,9,1,0.34006,0.01011,7,winner,loser
Tunisia,Morocco,2,2,FIFA World Cup qualification,France,13,6,1969,0,0,4,1141,1,0,Tunisia,Morocco,9,0,0.96877,0.64948,7,draw,draw
Ecuador,Uruguay,0,2,FIFA World Cup qualification,Ecuador,6,7,1969,-2,2,2,1142,0,1,Ecuador,Uruguay,9,2,0.7357,0.98845,7,loser,winner
Uruguay,Ecuador,1,0,FIFA World Cup qualification,Uruguay,20,7,1969,1,-1,1,1143,1,0,Uruguay,Ecuador,9,1,0.10814,0.39169,7,winner,loser
Poland,Netherlands,2,1,FIFA World Cup qualification,Poland,7,9,1969,1,-1,3,1144,0,1,Poland,Netherlands,9,1,0.17861,0.12483,7,winner,loser
Japan,Australia,1,3,FIFA World Cup qualification,South Korea,10,10,1969,-2,2,4,1145,0,0,Japan,Australia,9,2,0.47659,0.39445,7,loser,winner
South Korea,Japan,2,2,FIFA World Cup qualification,South Korea,12,10,1969,0,0,4,1146,0,0,South_Korea,Japan,9,0,0.24123,0.57486,7,draw,draw
South Korea,Australia,1,2,FIFA World Cup qualification,South Korea,14,10,1969,-1,1,3,1147,0,0,South_Korea,Australia,9,1,0.34491,0.91144,7,loser,winner
Australia,Japan,1,1,FIFA World Cup qualification,South Korea,16,10,1969,0,0,2,1148,0,0,Australia,Japan,9,0,0.59037,0.84053,7,draw,draw
South Korea,Japan,2,0,FIFA World Cup qualification,South Korea,18,10,1969,2,-2,2,1149,0,0,South_Korea,Japan,9,2,0.21292,0.46009,7,winner,loser
South Korea,Australia,1,1,FIFA World Cup qualification,South Korea,20,10,1969,0,0,2,1150,0,0,South_Korea,Australia,9,0,0.27249,0.21235,7,draw,draw
Switzerland,Portugal,1,1,FIFA World Cup qualification,Switzerland,2,11,1969,0,0,2,1151,0,1,Switzerland,Portugal,9,0,0.09885,0.90823,7,draw,draw
Mexico,Belgium,1,0,Friendly,Mexico,5,11,1969,1,-1,1,1152,1,1,Mexico,Belgium,9,1,0.68033,0.35397,7,winner,loser
Netherlands,England,0,1,Friendly,Netherlands,5,11,1969,-1,1,1,1153,1,1,Netherlands,England,9,1,0.73232,0.44607,7,loser,winner
Costa Rica,Mexico,2,0,CONCACAF Championship,Costa Rica,30,11,1969,2,-2,2,1154,1,1,Costa_Rica,Mexico,9,2,0.50958,0.87941,7,winner,loser
England,Portugal,1,0,Friendly,England,10,12,1969,1,-1,1,1155,1,1,England,Portugal,9,1,0.11945,0.03612,7,winner,loser
England,Netherlands,0,0,Friendly,England,14,1,1970,0,0,0,1156,1,1,England,Netherlands,0,0,0.98517,0.76666,8,draw,draw
Spain,Germany,2,0,Friendly,Spain,11,2,1970,2,-2,2,1157,1,1,Spain,Germany,0,2,0.52594,0.21104,8,winner,loser
Belgium,England,1,3,Friendly,Belgium,25,2,1970,-2,2,4,1158,1,1,Belgium,England,0,2,0.56637,0.39571,8,loser,winner
Brazil,Argentina,0,2,Friendly,Brazil,4,3,1970,-2,2,2,1159,0,1,Brazil,Argentina,0,2,0.29696,0.60171,8,loser,winner
Brazil,Argentina,2,1,Friendly,Brazil,8,3,1970,1,-1,3,1160,0,1,Brazil,Argentina,0,1,0.12338,0.17259,8,winner,loser
Saudi Arabia,Qatar,1,1,Gulf Cup,Bahrain,2,4,1970,0,0,2,1161,1,0,Saudi_Arabia,Qatar,0,0,0.94014,0.02066,8,draw,draw
Argentina,Uruguay,2,1,Friendly,Argentina,8,4,1970,1,-1,3,1162,1,1,Argentina,Uruguay,0,1,0.47588,0.48717,8,winner,loser
Uruguay,Argentina,2,1,Friendly,Uruguay,15,4,1970,1,-1,3,1163,1,1,Uruguay,Argentina,0,1,0.62296,0.10478,8,winner,loser
Wales,England,1,1,British Championship,Wales,18,4,1970,0,0,2,1164,0,1,Wales,England,0,0,0.80602,0.73514,8,draw,draw
Switzerland,Spain,0,1,Friendly,Switzerland,22,4,1970,-1,1,1,1165,0,1,Switzerland,Spain,0,1,0.51768,0.08535,8,loser,winner
Mexico,Ecuador,4,2,Friendly,Mexico,29,4,1970,2,-2,6,1166,1,0,Mexico,Ecuador,0,2,0.85649,0.01033,8,winner,loser
Switzerland,France,2,1,Friendly,Switzerland,3,5,1970,1,-1,3,1167,0,0,Switzerland,France,0,1,0.99474,0.88751,8,winner,loser
Denmark,Poland,0,2,Friendly,Denmark,19,5,1970,-2,2,2,1168,1,0,Denmark,Poland,0,2,0.09091,0.45453,8,loser,winner
Ecuador,England,0,2,Friendly,Ecuador,24,5,1970,-2,2,2,1169,0,1,Ecuador,England,0,2,0.48097,0.15711,8,loser,winner
Germany,Morocco,2,1,FIFA World Cup,Mexico,3,6,1970,1,-1,3,1170,1,0,Germany,Morocco,0,1,0.17794,0.6167,8,winner,loser
Brazil,England,1,0,FIFA World Cup,Mexico,7,6,1970,1,-1,1,1171,0,1,Brazil,England,0,1,0.62006,0.3008,8,winner,loser
Mexico,Belgium,1,0,FIFA World Cup,Mexico,11,6,1970,1,-1,1,1172,1,1,Mexico,Belgium,0,1,0.63045,0.0127,8,winner,loser
England,Germany,2,3,FIFA World Cup,Mexico,14,6,1970,-1,1,5,1173,1,1,England,Germany,0,1,0.68278,0.26656,8,loser,winner
Brazil,Uruguay,3,1,FIFA World Cup,Mexico,17,6,1970,2,-2,4,1174,0,1,Brazil,Uruguay,0,2,0.74637,0.44586,8,winner,loser
Germany,Uruguay,1,0,FIFA World Cup,Mexico,20,6,1970,1,-1,1,1175,1,1,Germany,Uruguay,0,1,0.82339,0.62881,8,winner,loser
Japan,South Korea,1,1,Merdeka Tournament,Malaysia,2,8,1970,0,0,2,1176,0,0,Japan,South_Korea,0,0,0.58518,0.49369,8,draw,draw
Poland,Denmark,5,0,Friendly,Poland,2,9,1970,5,-5,5,1177,0,1,Poland,Denmark,0,5,0.28992,0.35578,8,winner,loser
Brazil,Mexico,2,1,Friendly,Brazil,30,9,1970,1,-1,3,1178,0,1,Brazil,Mexico,0,1,0.82023,0.46499,8,winner,loser
Denmark,Portugal,0,1,UEFA Euro qualification,Denmark,14,10,1970,-1,1,1,1179,1,1,Denmark,Portugal,0,1,0.7396,0.50395,8,loser,winner
Iran,Australia,1,2,Friendly,Iran,4,11,1970,-1,1,3,1180,1,0,Iran,Australia,0,1,0.16375,0.61266,8,loser,winner
Belgium,France,1,2,Friendly,Belgium,15,11,1970,-1,1,3,1181,1,0,Belgium,France,0,1,0.42023,0.80419,8,loser,winner
Belgium,Denmark,2,0,UEFA Euro qualification,Belgium,25,11,1970,2,-2,2,1182,1,1,Belgium,Denmark,0,2,0.11256,0.29305,8,winner,loser
Argentina,France,3,4,Friendly,Argentina,8,1,1971,-1,1,7,1183,1,0,Argentina,France,1,1,0.19774,0.2988,8,loser,winner
Argentina,France,2,0,Friendly,Argentina,13,1,1971,2,-2,2,1184,1,0,Argentina,France,1,2,0.1285,0.55828,8,winner,loser
Belgium,Portugal,3,0,UEFA Euro qualification,Belgium,17,2,1971,3,-3,3,1185,1,1,Belgium,Portugal,1,3,0.83745,0.89615,8,winner,loser
Cameroon,Senegal,1,1,Friendly,Cameroon,4,3,1971,0,0,2,1186,1,0,Cameroon,Senegal,1,0,0.73876,0.09473,8,draw,draw
Cameroon,Senegal,1,2,Friendly,Cameroon,7,3,1971,-1,1,3,1187,1,0,Cameroon,Senegal,1,1,0.28199,0.74533,8,loser,winner
Senegal,Cameroon,3,0,Friendly,Senegal,10,3,1971,3,-3,3,1188,0,1,Senegal,Cameroon,1,3,0.96324,0.61613,8,winner,loser
Spain,France,2,2,Friendly,Spain,17,3,1971,0,0,4,1189,1,0,Spain,France,1,0,0.47442,0.84982,8,draw,draw
Switzerland,Poland,2,4,Friendly,Switzerland,5,5,1971,-2,2,6,1190,0,0,Switzerland,Poland,1,2,0.48438,0.01854,8,loser,winner
Portugal,Denmark,5,0,UEFA Euro qualification,Portugal,12,5,1971,5,-5,5,1191,1,1,Portugal,Denmark,1,5,0.20354,0.73271,8,winner,loser
England,Wales,0,0,British Championship,England,19,5,1971,0,0,0,1192,1,0,England,Wales,1,0,0.80754,0.26029,8,draw,draw
Denmark,Belgium,1,2,UEFA Euro qualification,Denmark,26,5,1971,-1,1,3,1193,1,1,Denmark,Belgium,1,1,0.48121,0.23577,8,loser,winner
Denmark,Germany,1,3,Friendly,Denmark,30,6,1971,-2,2,4,1194,1,1,Denmark,Germany,1,2,0.58858,0.91203,8,loser,winner
Argentina,Uruguay,1,0,Friendly,Argentina,14,7,1971,1,-1,1,1195,1,1,Argentina,Uruguay,1,1,0.31184,0.1489,8,winner,loser
Uruguay,Argentina,1,1,Friendly,Uruguay,18,7,1971,0,0,2,1196,1,1,Uruguay,Argentina,1,0,0.28456,0.23431,8,draw,draw
Argentina,Brazil,1,1,Copa Roca,Argentina,28,7,1971,0,0,2,1197,1,0,Argentina,Brazil,1,0,0.62435,0.04419,8,draw,draw
Denmark,Japan,3,2,Friendly,Denmark,28,7,1971,1,-1,5,1198,1,0,Denmark,Japan,1,1,0.84017,0.35391,8,winner,loser
Argentina,Brazil,2,2,Copa Roca,Argentina,31,7,1971,0,0,4,1199,1,0,Argentina,Brazil,1,0,0.5771,0.52386,8,draw,draw
Germany,Mexico,5,0,Friendly,Germany,8,9,1971,5,-5,5,1200,1,1,Germany,Mexico,1,5,0.15812,0.59732,8,winner,loser
South Korea,Iran,2,0,Friendly,South Korea,10,9,1971,2,-2,2,1201,0,1,South_Korea,Iran,1,2,0.9725,0.98663,8,winner,loser
South Korea,Iran,0,2,Friendly,South Korea,12,9,1971,-2,2,2,1202,0,1,South_Korea,Iran,1,2,0.17541,0.82777,8,loser,winner
Poland,Germany,1,3,UEFA Euro qualification,Poland,10,10,1971,-2,2,4,1203,0,1,Poland,Germany,1,2,0.33541,0.23745,8,loser,winner
Switzerland,England,2,3,UEFA Euro qualification,Switzerland,13,10,1971,-1,1,5,1204,0,1,Switzerland,England,1,1,0.38855,0.43127,8,loser,winner
England,Switzerland,1,1,UEFA Euro qualification,England,10,11,1971,0,0,2,1205,1,0,England,Switzerland,1,0,0.98427,0.48535,8,draw,draw
Germany,Poland,0,0,UEFA Euro qualification,Germany,17,11,1971,0,0,0,1206,1,0,Germany,Poland,1,0,0.78998,0.05641,8,draw,draw
Portugal,Belgium,1,1,UEFA Euro qualification,Portugal,21,11,1971,0,0,2,1207,1,1,Portugal,Belgium,1,0,0.43902,0.23232,8,draw,draw
Costa Rica,Mexico,0,1,CONCACAF Championship,Trinidad and Tobago,2,12,1971,-1,1,1,1208,1,1,Costa_Rica,Mexico,1,1,0.79049,0.38934,8,loser,winner
Senegal,Morocco,1,3,Friendly,Senegal,17,2,1972,-2,2,4,1209,0,0,Senegal,Morocco,2,2,0.2653,0.50007,8,loser,winner
Saudi Arabia,Qatar,4,0,Gulf Cup,Saudi Arabia,24,3,1972,4,-4,4,1210,1,0,Saudi_Arabia,Qatar,2,4,0.10407,0.84833,8,winner,loser
England,Germany,1,3,UEFA Euro qualification,England,29,4,1972,-2,2,4,1211,1,1,England,Germany,2,2,0.34567,0.32738,8,loser,winner
Poland,Switzerland,0,0,Friendly,Poland,10,5,1972,0,0,0,1212,0,0,Poland,Switzerland,2,0,0.32066,0.34323,8,draw,draw
Germany,England,0,0,UEFA Euro qualification,Germany,13,5,1972,0,0,0,1213,1,1,Germany,England,2,0,0.6736,0.71469,8,draw,draw
Iran,South Korea,2,1,AFC Asian Cup,Thailand,19,5,1972,1,-1,3,1214,1,0,Iran,South_Korea,2,1,0.54554,0.87126,8,winner,loser
Wales,England,0,3,British Championship,Wales,20,5,1972,-3,3,3,1215,0,1,Wales,England,2,3,0.06698,0.74158,8,loser,winner
Spain,Uruguay,2,0,Friendly,Spain,23,5,1972,2,-2,2,1216,1,1,Spain,Uruguay,2,2,0.00287,0.21199,8,winner,loser
Ecuador,Portugal,0,3,Brazil Independence Cup,Brazil,11,6,1972,-3,3,3,1217,0,1,Ecuador,Portugal,2,3,0.24112,0.91031,8,loser,winner
Belgium,Germany,1,2,UEFA Euro,Belgium,14,6,1972,-1,1,3,1218,1,1,Belgium,Germany,2,1,0.95463,0.06028,8,loser,winner
Iran,Portugal,0,3,Brazil Independence Cup,Brazil,14,6,1972,-3,3,3,1219,1,1,Iran,Portugal,2,3,0.76844,0.1147,8,loser,winner
Ecuador,Iran,1,1,Brazil Independence Cup,Brazil,21,6,1972,0,0,2,1220,0,1,Ecuador,Iran,2,0,0.7754,0.07765,8,draw,draw
Argentina,France,0,0,Brazil Independence Cup,Brazil,25,6,1972,0,0,0,1221,1,0,Argentina,France,2,0,0.9998,0.40927,8,draw,draw
Argentina,Portugal,1,3,Brazil Independence Cup,Brazil,29,6,1972,-2,2,4,1222,1,1,Argentina,Portugal,2,2,0.70757,0.93788,8,loser,winner
Portugal,Uruguay,1,1,Brazil Independence Cup,Brazil,2,7,1972,0,0,2,1223,1,1,Portugal,Uruguay,2,0,0.23938,0.35397,8,draw,draw
Argentina,Uruguay,1,0,Brazil Independence Cup,Brazil,6,7,1972,1,-1,1,1224,1,1,Argentina,Uruguay,2,1,0.76494,0.25192,8,winner,loser
Brazil,Portugal,1,0,Brazil Independence Cup,Brazil,9,7,1972,1,-1,1,1225,0,1,Brazil,Portugal,2,1,0.7592,0.66413,8,winner,loser
Japan,South Korea,0,3,Merdeka Tournament,Malaysia,26,7,1972,-3,3,3,1226,0,0,Japan,South_Korea,2,3,0.28154,0.25576,8,loser,winner
Costa Rica,Mexico,1,0,Friendly,Costa Rica,6,8,1972,1,-1,1,1227,1,1,Costa_Rica,Mexico,2,1,0.48827,0.89541,8,winner,loser
Canada,United States,3,2,CONCACAF Championship qualification,Canada,20,8,1972,1,-1,5,1228,0,0,Canada,United_States,2,1,0.16911,0.77253,8,winner,loser
Canada,Mexico,0,1,CONCACAF Championship qualification,Canada,24,8,1972,-1,1,1,1229,0,1,Canada,Mexico,2,1,0.75745,0.99706,8,loser,winner
United States,Canada,2,2,CONCACAF Championship qualification,United States,29,8,1972,0,0,4,1230,0,0,United_States,Canada,2,0,0.30064,0.6223,8,draw,draw
Mexico,United States,3,1,CONCACAF Championship qualification,Mexico,3,9,1972,2,-2,4,1231,1,0,Mexico,United_States,2,2,0.5553,0.15339,8,winner,loser
Mexico,Canada,2,1,CONCACAF Championship qualification,Mexico,6,9,1972,1,-1,3,1232,1,0,Mexico,Canada,2,1,0.16701,0.02889,8,winner,loser
United States,Mexico,1,2,CONCACAF Championship qualification,United States,10,9,1972,-1,1,3,1233,0,1,United_States,Mexico,2,1,0.90077,0.39839,8,loser,winner
Japan,South Korea,2,2,Friendly,Japan,14,9,1972,0,0,4,1234,0,0,Japan,South_Korea,2,0,0.96517,0.2837,8,draw,draw
Denmark,Switzerland,1,1,Friendly,Denmark,4,10,1972,0,0,2,1235,1,0,Denmark,Switzerland,2,0,0.5862,0.70977,8,draw,draw
Spain,Argentina,1,0,Friendly,Spain,11,10,1972,1,-1,1,1236,1,1,Spain,Argentina,2,1,0.82916,0.85721,8,winner,loser
Mexico,Costa Rica,3,1,Friendly,Mexico,12,10,1972,2,-2,4,1237,1,1,Mexico,Costa_Rica,2,2,0.99986,0.92217,8,winner,loser
South Korea,Australia,1,1,Friendly,South Korea,22,10,1972,0,0,2,1238,0,0,South_Korea,Australia,2,0,0.17559,0.64992,8,draw,draw
South Korea,Australia,0,2,Friendly,South Korea,24,10,1972,-2,2,2,1239,0,0,South_Korea,Australia,2,2,0.09716,0.57539,8,loser,winner
Germany,Switzerland,5,1,Friendly,Germany,15,11,1972,4,-4,6,1240,1,0,Germany,Switzerland,2,4,0.19155,0.50664,8,winner,loser
Wales,England,0,1,FIFA World Cup qualification,Wales,15,11,1972,-1,1,1,1241,0,1,Wales,England,2,1,0.27675,0.70128,8,loser,winner
Belgium,Netherlands,0,0,FIFA World Cup qualification,Belgium,19,11,1972,0,0,0,1242,1,1,Belgium,Netherlands,2,0,0.28875,0.79171,8,draw,draw
Morocco,Senegal,0,0,FIFA World Cup qualification,Morocco,19,11,1972,0,0,0,1243,0,0,Morocco,Senegal,2,0,0.40272,0.63459,8,draw,draw
Senegal,Morocco,1,2,FIFA World Cup qualification,Senegal,3,12,1972,-1,1,3,1244,0,0,Senegal,Morocco,2,1,0.26399,0.20017,8,loser,winner
England,Wales,1,1,FIFA World Cup qualification,England,24,1,1973,0,0,2,1245,1,0,England,Wales,3,0,0.92858,0.65497,8,draw,draw
Mexico,Argentina,2,0,Friendly,Mexico,6,2,1973,2,-2,2,1246,1,1,Mexico,Argentina,3,2,0.88027,0.61609,8,winner,loser
Germany,Argentina,2,3,Friendly,Germany,14,2,1973,-1,1,5,1247,1,1,Germany,Argentina,3,1,0.6476,0.27564,8,loser,winner
Morocco,Senegal,3,1,Friendly,Morocco,17,2,1973,2,-2,4,1248,0,0,Morocco,Senegal,3,2,0.75822,0.60677,8,winner,loser
France,Portugal,1,2,Friendly,France,3,3,1973,-1,1,3,1249,0,1,France,Portugal,3,1,0.96636,0.99485,8,loser,winner
Poland,United States,4,0,Friendly,Poland,20,3,1973,4,-4,4,1250,0,0,Poland,United_States,3,4,0.81885,0.43284,8,winner,loser
Wales,Poland,2,0,FIFA World Cup qualification,Wales,28,3,1973,2,-2,2,1251,0,0,Wales,Poland,3,2,0.60939,0.76119,8,winner,loser
Senegal,Ghana,1,0,African Cup of Nations qualification,Senegal,21,4,1973,1,-1,1,1252,0,0,Senegal,Ghana,3,1,0.17026,0.95554,8,winner,loser
Netherlands,Spain,3,2,Friendly,Netherlands,2,5,1973,1,-1,5,1253,1,1,Netherlands,Spain,3,1,0.97288,0.70319,8,winner,loser
England,Wales,3,0,British Championship,England,15,5,1973,3,-3,3,1254,1,0,England,Wales,3,3,0.51781,0.01032,8,winner,loser
Argentina,Uruguay,1,1,Copa Lipton,Argentina,17,5,1973,0,0,2,1255,1,1,Argentina,Uruguay,3,0,0.21423,0.00498,8,draw,draw
Uruguay,Argentina,1,1,Copa Newton,Uruguay,23,5,1973,0,0,2,1256,1,1,Uruguay,Argentina,3,0,0.32346,0.27821,8,draw,draw
Poland,England,2,0,FIFA World Cup qualification,Poland,6,6,1973,2,-2,2,1257,0,1,Poland,England,3,2,0.73968,0.34735,8,winner,loser
Tunisia,Brazil,1,4,Friendly,Tunisia,6,6,1973,-3,3,5,1258,1,0,Tunisia,Brazil,3,3,0.67895,0.33324,8,loser,winner
Germany,Brazil,0,1,Friendly,Germany,16,6,1973,-1,1,1,1259,1,0,Germany,Brazil,3,1,0.81032,0.94967,8,loser,winner
South Korea,Japan,2,0,Friendly,South Korea,23,6,1973,2,-2,2,1260,0,0,South_Korea,Japan,3,2,0.04732,0.71947,8,winner,loser
Ecuador,Uruguay,1,2,FIFA World Cup qualification,Ecuador,1,7,1973,-1,1,3,1261,0,1,Ecuador,Uruguay,3,1,0.58837,0.83039,8,loser,winner
Uruguay,Ecuador,4,0,FIFA World Cup qualification,Uruguay,8,7,1973,4,-4,4,1262,1,0,Uruguay,Ecuador,3,4,0.6752,0.44516,8,winner,loser
Canada,Poland,1,3,Friendly,Canada,1,8,1973,-2,2,4,1263,0,0,Canada,Poland,3,2,0.51059,0.49028,8,loser,winner
United States,Poland,0,1,Friendly,United States,3,8,1973,-1,1,1,1264,0,0,United_States,Poland,3,1,0.48372,0.1456,8,loser,winner
Canada,United States,0,2,Friendly,Canada,5,8,1973,-2,2,2,1265,0,0,Canada,United_States,3,2,0.01694,0.57107,8,loser,winner
Mexico,Poland,0,1,Friendly,United States,5,8,1973,-1,1,1,1266,1,0,Mexico,Poland,3,1,0.5888,0.85232,8,loser,winner
Mexico,Poland,1,2,Friendly,Mexico,8,8,1973,-1,1,3,1267,1,0,Mexico,Poland,3,1,0.06787,0.4272,8,loser,winner
United States,Poland,0,4,Friendly,United States,10,8,1973,-4,4,4,1268,0,0,United_States,Poland,3,4,0.05183,0.50456,8,loser,winner
United States,Poland,1,0,Friendly,United States,12,8,1973,1,-1,1,1269,0,0,United_States,Poland,3,1,0.89933,0.18411,8,winner,loser
Australia,Iran,3,0,FIFA World Cup qualification,Australia,18,8,1973,3,-3,3,1270,0,1,Australia,Iran,3,3,0.85043,0.21471,8,winner,loser
Iran,Australia,2,0,FIFA World Cup qualification,Iran,24,8,1973,2,-2,2,1271,1,0,Iran,Australia,3,2,0.11201,0.00594,8,winner,loser
Poland,Wales,3,0,FIFA World Cup qualification,Poland,26,9,1973,3,-3,3,1272,0,0,Poland,Wales,3,3,0.00711,0.85271,8,winner,loser
Netherlands,Poland,1,1,Friendly,Netherlands,10,10,1973,0,0,2,1273,1,0,Netherlands,Poland,3,0,0.32506,0.46185,8,draw,draw
Germany,France,2,1,Friendly,Germany,13,10,1973,1,-1,3,1274,1,0,Germany,France,3,1,0.09237,0.69008,8,winner,loser
Mexico,United States,2,0,Friendly,Mexico,16,10,1973,2,-2,2,1275,1,0,Mexico,United_States,3,2,0.49762,0.57849,8,winner,loser
England,Poland,1,1,FIFA World Cup qualification,England,17,10,1973,0,0,2,1276,1,0,England,Poland,3,0,0.56917,0.87088,8,draw,draw
Australia,South Korea,0,0,FIFA World Cup qualification,Australia,28,10,1973,0,0,0,1277,0,0,Australia,South_Korea,3,0,0.02969,0.24479,8,draw,draw
South Korea,Australia,2,2,FIFA World Cup qualification,South Korea,10,11,1973,0,0,4,1278,0,0,South_Korea,Australia,3,0,0.387,0.47877,8,draw,draw
Australia,South Korea,1,0,FIFA World Cup qualification,Hong Kong,13,11,1973,1,-1,1,1279,0,0,Australia,South_Korea,3,1,0.27043,0.8055,8,winner,loser
Netherlands,Belgium,0,0,FIFA World Cup qualification,Netherlands,18,11,1973,0,0,0,1280,1,1,Netherlands,Belgium,3,0,0.76461,0.91484,8,draw,draw
France,Denmark,3,0,Friendly,France,21,11,1973,3,-3,3,1281,0,1,France,Denmark,3,3,0.79003,0.66872,8,winner,loser
Germany,Spain,2,1,Friendly,Germany,24,11,1973,1,-1,3,1282,1,1,Germany,Spain,3,1,0.44858,0.38278,8,winner,loser
Spain,Germany,1,0,Friendly,Spain,23,2,1974,1,-1,1,1283,1,1,Spain,Germany,4,1,0.14612,0.51724,8,winner,loser
Qatar,Morocco,0,1,Friendly,Qatar,27,2,1974,-1,1,1,1284,0,0,Qatar,Morocco,4,1,0.08387,0.34474,8,loser,winner
Saudi Arabia,Morocco,0,0,Friendly,Saudi Arabia,6,3,1974,0,0,0,1285,1,0,Saudi_Arabia,Morocco,4,0,0.29406,0.83525,8,draw,draw
Qatar,Saudi Arabia,0,2,Gulf Cup,Kuwait,16,3,1974,-2,2,2,1286,0,1,Qatar,Saudi_Arabia,4,2,0.99333,0.19067,8,loser,winner
Qatar,Saudi Arabia,1,3,Gulf Cup,Kuwait,26,3,1974,-2,2,4,1287,0,1,Qatar,Saudi_Arabia,4,2,0.4433,0.47231,8,loser,winner
Brazil,Mexico,1,1,Friendly,Brazil,31,3,1974,0,0,2,1288,0,1,Brazil,Mexico,4,0,0.03469,0.06137,8,draw,draw
Portugal,England,0,0,Friendly,Portugal,3,4,1974,0,0,0,1289,1,1,Portugal,England,4,0,0.87296,0.70553,8,draw,draw
Belgium,Poland,1,1,Friendly,Belgium,17,4,1974,0,0,2,1290,1,0,Belgium,Poland,4,0,0.75647,0.24271,8,draw,draw
Switzerland,Belgium,0,1,Friendly,Switzerland,1,5,1974,-1,1,1,1291,0,1,Switzerland,Belgium,4,1,0.45468,0.12426,8,loser,winner
Wales,England,0,2,British Championship,Wales,11,5,1974,-2,2,2,1292,0,1,Wales,England,4,2,0.77369,0.76791,8,loser,winner
France,Argentina,0,1,Friendly,France,18,5,1974,-1,1,1,1293,0,1,France,Argentina,4,1,0.46156,0.15014,8,loser,winner
England,Argentina,2,2,Friendly,England,22,5,1974,0,0,4,1294,1,1,England,Argentina,4,0,0.41796,0.31784,8,draw,draw
Netherlands,Argentina,4,1,Friendly,Netherlands,26,5,1974,3,-3,5,1295,1,1,Netherlands,Argentina,4,3,0.58026,0.01908,8,winner,loser
Poland,Argentina,3,2,FIFA World Cup,Germany,15,6,1974,1,-1,5,1296,0,1,Poland,Argentina,4,1,0.70254,0.14497,8,winner,loser
Uruguay,Netherlands,0,2,FIFA World Cup,Germany,15,6,1974,-2,2,2,1297,1,1,Uruguay,Netherlands,4,2,0.64812,0.70309,8,loser,winner
Germany,Australia,3,0,FIFA World Cup,Germany,18,6,1974,3,-3,3,1298,1,0,Germany,Australia,4,3,0.75388,0.05207,8,winner,loser
Netherlands,Argentina,4,0,FIFA World Cup,Germany,26,6,1974,4,-4,4,1299,1,1,Netherlands,Argentina,4,4,0.79874,0.0334,8,winner,loser
Argentina,Brazil,1,2,FIFA World Cup,Germany,30,6,1974,-1,1,3,1300,1,0,Argentina,Brazil,4,1,0.63349,0.28688,8,loser,winner
Germany,Poland,1,0,FIFA World Cup,Germany,3,7,1974,1,-1,1,1301,1,0,Germany,Poland,4,1,0.09006,0.82295,8,winner,loser
Netherlands,Brazil,2,0,FIFA World Cup,Germany,3,7,1974,2,-2,2,1302,1,0,Netherlands,Brazil,4,2,0.6626,0.17211,8,winner,loser
Brazil,Poland,0,1,FIFA World Cup,Germany,6,7,1974,-1,1,1,1303,0,0,Brazil,Poland,4,1,0.02132,0.27153,8,loser,winner
Germany,Netherlands,2,1,FIFA World Cup,Germany,7,7,1974,1,-1,3,1304,1,1,Germany,Netherlands,4,1,0.89584,0.59412,8,winner,loser
Switzerland,Germany,1,2,Friendly,Switzerland,4,9,1974,-1,1,3,1305,0,1,Switzerland,Germany,4,1,0.407,0.37123,8,loser,winner
Mexico,United States,3,1,Friendly,Mexico,5,9,1974,2,-2,4,1306,1,0,Mexico,United_States,4,2,0.67746,0.32243,8,winner,loser
Poland,France,0,2,Friendly,Poland,7,9,1974,-2,2,2,1307,0,0,Poland,France,4,2,0.42287,0.399,8,loser,winner
United States,Mexico,0,1,Friendly,United States,8,9,1974,-1,1,1,1308,0,1,United_States,Mexico,4,1,0.88313,0.15007,8,loser,winner
Denmark,Spain,1,2,UEFA Euro qualification,Denmark,25,9,1974,-1,1,3,1309,1,1,Denmark,Spain,4,1,0.31286,0.02193,8,loser,winner
Japan,South Korea,4,1,Friendly,Japan,28,9,1974,3,-3,5,1310,0,0,Japan,South_Korea,4,3,0.76459,0.39366,8,winner,loser
Morocco,Tunisia,3,1,Kuneitra Cup,Syria,1,10,1974,2,-2,4,1311,0,1,Morocco,Tunisia,4,2,0.92086,0.00225,8,winner,loser
Netherlands,Switzerland,1,0,Friendly,Netherlands,9,10,1974,1,-1,1,1312,1,0,Netherlands,Switzerland,4,1,0.63661,0.80789,8,winner,loser
Argentina,Spain,1,1,Friendly,Argentina,12,10,1974,0,0,2,1313,1,1,Argentina,Spain,4,0,0.9462,0.80795,8,draw,draw
Belgium,France,2,1,UEFA Euro qualification,Belgium,12,10,1974,1,-1,3,1314,1,0,Belgium,France,4,1,0.84732,0.39143,8,winner,loser
Poland,Canada,2,0,Friendly,Poland,31,10,1974,2,-2,2,1315,0,0,Poland,Canada,4,2,0.65707,0.73168,8,winner,loser
Switzerland,Portugal,3,0,Friendly,Switzerland,13,11,1974,3,-3,3,1316,0,1,Switzerland,Portugal,4,3,0.88034,0.33937,8,winner,loser
England,Portugal,0,0,UEFA Euro qualification,England,20,11,1974,0,0,0,1317,1,1,England,Portugal,4,0,0.19115,0.10551,8,draw,draw
Morocco,Tunisia,0,0,Friendly,Morocco,2,3,1975,0,0,0,1318,0,1,Morocco,Tunisia,5,0,0.89289,0.32731,8,draw,draw
Brazil,Portugal,2,1,Friendly,Brazil,9,3,1975,1,-1,3,1319,0,1,Brazil,Portugal,5,1,0.02176,0.39955,8,winner,loser
England,Germany,2,0,Friendly,England,12,3,1975,2,-2,2,1320,1,1,England,Germany,5,2,0.16954,0.82315,8,winner,loser
Poland,United States,7,0,Friendly,Poland,26,3,1975,7,-7,7,1321,0,0,Poland,United_States,5,7,0.45957,0.78384,8,winner,loser
Saudi Arabia,Qatar,2,1,AFC Asian Cup qualification,Iraq,4,4,1975,1,-1,3,1322,1,0,Saudi_Arabia,Qatar,5,1,0.41324,0.3452,8,winner,loser
Saudi Arabia,Qatar,0,1,AFC Asian Cup qualification,Iraq,14,4,1975,-1,1,1,1323,1,0,Saudi_Arabia,Qatar,5,1,0.6415,0.08318,8,loser,winner
France,Portugal,0,2,Friendly,France,26,4,1975,-2,2,2,1324,0,1,France,Portugal,5,2,0.13202,0.37754,8,loser,winner
Belgium,Netherlands,1,0,Friendly,Belgium,30,4,1975,1,-1,1,1325,1,1,Belgium,Netherlands,5,1,0.18282,0.97453,8,winner,loser
Germany,Netherlands,1,1,Friendly,Germany,17,5,1975,0,0,2,1326,1,1,Germany,Netherlands,5,0,0.92466,0.82237,8,draw,draw
England,Wales,2,2,British Championship,England,21,5,1975,0,0,4,1327,1,0,England,Wales,5,0,0.67339,0.09619,8,draw,draw
United States,Poland,0,4,Friendly,United States,24,6,1975,-4,4,4,1328,0,0,United_States,Poland,5,4,0.57534,0.06477,8,loser,winner
Canada,Poland,1,8,Friendly,Canada,6,7,1975,-7,7,9,1329,0,0,Canada,Poland,5,7,0.8776,0.54594,8,loser,winner
Canada,Poland,1,4,Friendly,Canada,9,7,1975,-3,3,5,1330,0,0,Canada,Poland,5,3,0.70329,0.28056,8,loser,winner
Uruguay,Argentina,2,3,Copa Newton,Uruguay,18,7,1975,-1,1,5,1331,1,1,Uruguay,Argentina,5,1,0.46543,0.14926,8,loser,winner
Brazil,Argentina,2,1,Copa America,Brazil,6,8,1975,1,-1,3,1332,0,1,Brazil,Argentina,5,1,0.29881,0.64975,8,winner,loser
Japan,South Korea,1,3,Merdeka Tournament,Malaysia,9,8,1975,-2,2,4,1333,0,0,Japan,South_Korea,5,2,0.5513,0.76059,8,loser,winner
Argentina,Brazil,0,1,Copa America,Argentina,16,8,1975,-1,1,1,1334,1,0,Argentina,Brazil,5,1,0.76178,0.54927,8,loser,winner
Mexico,Costa Rica,7,0,Friendly,Mexico,17,8,1975,7,-7,7,1335,1,1,Mexico,Costa_Rica,5,7,0.11421,0.74551,8,winner,loser
Costa Rica,United States,3,1,Friendly,Mexico,19,8,1975,2,-2,4,1336,1,0,Costa_Rica,United_States,5,2,0.62327,0.1895,8,winner,loser
Argentina,United States,6,0,Friendly,Mexico,21,8,1975,6,-6,6,1337,1,0,Argentina,United_States,5,6,0.09013,0.15387,8,winner,loser
Mexico,United States,2,0,Friendly,Mexico,24,8,1975,2,-2,2,1338,1,0,Mexico,United_States,5,2,0.72153,0.19639,8,winner,loser
Mexico,Argentina,1,1,Friendly,Mexico,31,8,1975,0,0,2,1339,1,1,Mexico,Argentina,5,0,0.64589,0.57656,8,draw,draw
Switzerland,England,1,2,Friendly,Switzerland,3,9,1975,-1,1,3,1340,0,1,Switzerland,England,5,1,0.03975,0.45355,8,loser,winner
South Korea,Japan,3,0,Friendly,South Korea,8,9,1975,3,-3,3,1341,0,0,South_Korea,Japan,5,3,0.75458,0.80879,8,winner,loser
Poland,Netherlands,4,1,UEFA Euro qualification,Poland,10,9,1975,3,-3,5,1342,0,1,Poland,Netherlands,5,3,0.0345,0.99507,8,winner,loser
Spain,Denmark,2,0,UEFA Euro qualification,Spain,12,10,1975,2,-2,2,1343,1,1,Spain,Denmark,5,2,0.23361,0.07618,8,winner,loser
Netherlands,Poland,3,0,UEFA Euro qualification,Netherlands,15,10,1975,3,-3,3,1344,1,0,Netherlands,Poland,5,3,0.37969,0.65135,8,winner,loser
France,Belgium,0,0,UEFA Euro qualification,France,15,11,1975,0,0,0,1345,0,1,France,Belgium,5,0,0.73128,0.6299,8,draw,draw
Portugal,England,1,1,UEFA Euro qualification,Portugal,19,11,1975,0,0,2,1346,1,1,Portugal,England,5,0,0.18679,0.11729,8,draw,draw
Saudi Arabia,Morocco,0,2,Friendly,Saudi Arabia,20,2,1976,-2,2,2,1347,1,0,Saudi_Arabia,Morocco,6,2,0.13447,0.70449,8,loser,winner
Uruguay,Brazil,1,2,Copa Rio Branco,Uruguay,25,2,1976,-1,1,3,1348,1,0,Uruguay,Brazil,6,1,0.14584,0.80691,8,loser,winner
Argentina,Brazil,1,2,Copa Roca,Argentina,27,2,1976,-1,1,3,1349,1,0,Argentina,Brazil,6,1,0.15107,0.62094,8,loser,winner
Poland,Argentina,1,2,Friendly,Poland,24,3,1976,-1,1,3,1350,0,1,Poland,Argentina,6,1,0.21224,0.92174,8,loser,winner
Wales,England,1,2,Friendly,Wales,24,3,1976,-1,1,3,1351,0,1,Wales,England,6,1,0.54945,0.33135,8,loser,winner
Qatar,Saudi Arabia,1,0,Gulf Cup,Qatar,26,3,1976,1,-1,1,1352,0,1,Qatar,Saudi_Arabia,6,1,0.07161,0.30838,8,winner,loser
Argentina,Uruguay,4,1,Copa Lipton,Argentina,8,4,1976,3,-3,5,1353,1,1,Argentina,Uruguay,6,3,0.07355,0.49426,8,winner,loser
France,Poland,2,0,Friendly,France,24,4,1976,2,-2,2,1354,0,0,France,Poland,6,2,0.29541,0.76063,8,winner,loser
Spain,Germany,1,1,UEFA Euro qualification,Spain,24,4,1976,0,0,2,1355,1,1,Spain,Germany,6,0,0.57066,0.66024,8,draw,draw
Netherlands,Belgium,5,0,UEFA Euro qualification,Netherlands,25,4,1976,5,-5,5,1356,1,1,Netherlands,Belgium,6,5,0.31684,0.59652,8,winner,loser
Brazil,Uruguay,2,1,Copa Rio Branco,Brazil,28,4,1976,1,-1,3,1357,0,1,Brazil,Uruguay,6,1,0.86382,0.49723,8,winner,loser
Wales,England,0,1,British Championship,Wales,8,5,1976,-1,1,1,1358,0,1,Wales,England,6,1,0.85909,0.54796,8,loser,winner
Switzerland,Poland,2,1,Friendly,Switzerland,11,5,1976,1,-1,3,1359,0,0,Switzerland,Poland,6,1,0.69001,0.97067,8,winner,loser
Brazil,Argentina,2,0,Copa Roca,Brazil,19,5,1976,2,-2,2,1360,0,1,Brazil,Argentina,6,2,0.72866,0.93843,8,winner,loser
Belgium,Netherlands,1,2,UEFA Euro qualification,Belgium,22,5,1976,-1,1,3,1361,1,1,Belgium,Netherlands,6,1,0.87192,0.48736,8,loser,winner
Germany,Spain,2,0,UEFA Euro qualification,Germany,22,5,1976,2,-2,2,1362,1,1,Germany,Spain,6,2,0.35649,0.00462,8,winner,loser
Brazil,England,1,0,Friendly,United States,23,5,1976,1,-1,1,1363,0,1,Brazil,England,6,1,0.32046,0.30315,8,winner,loser
Mexico,Brazil,0,3,Friendly,Mexico,4,6,1976,-3,3,3,1364,1,0,Mexico,Brazil,6,3,0.25748,0.95983,8,loser,winner
Uruguay,Argentina,0,3,Copa Newton,Uruguay,9,6,1976,-3,3,3,1365,1,1,Uruguay,Argentina,6,3,0.90622,0.72768,8,loser,winner
Japan,South Korea,0,0,Merdeka Tournament,Malaysia,18,8,1976,0,0,0,1366,0,0,Japan,South_Korea,6,0,0.28412,0.39728,8,draw,draw
Denmark,France,1,1,Friendly,Denmark,1,9,1976,0,0,2,1367,1,0,Denmark,France,6,0,0.31977,0.65339,8,draw,draw
Saudi Arabia,Morocco,0,2,Friendly,Saudi Arabia,12,9,1976,-2,2,2,1368,1,0,Saudi_Arabia,Morocco,6,2,0.87221,0.73523,8,loser,winner
Canada,United States,1,1,CONCACAF Championship qualification,Canada,24,9,1976,0,0,2,1369,0,0,Canada,United_States,6,0,0.75418,0.86215,8,draw,draw
Saudi Arabia,Tunisia,0,1,Friendly,Saudi Arabia,30,9,1976,-1,1,1,1370,1,1,Saudi_Arabia,Tunisia,6,1,0.76908,0.09599,8,loser,winner
United States,Mexico,0,0,CONCACAF Championship qualification,United States,3,10,1976,0,0,0,1371,0,1,United_States,Mexico,6,0,0.85668,0.9995,8,draw,draw
Wales,Germany,0,2,Friendly,Wales,6,10,1976,-2,2,2,1372,0,1,Wales,Germany,6,2,0.62849,0.69706,8,loser,winner
Canada,Mexico,1,0,CONCACAF Championship qualification,Canada,10,10,1976,1,-1,1,1373,0,1,Canada,Mexico,6,1,0.24818,0.48327,8,winner,loser
Mexico,United States,3,0,CONCACAF Championship qualification,Mexico,15,10,1976,3,-3,3,1374,1,0,Mexico,United_States,6,3,0.25317,0.84512,8,winner,loser
Portugal,Poland,0,2,FIFA World Cup qualification,Portugal,16,10,1976,-2,2,2,1375,1,0,Portugal,Poland,6,2,0.12758,0.00582,8,loser,winner
Ecuador,Uruguay,2,2,Friendly,Ecuador,20,10,1976,0,0,4,1376,0,1,Ecuador,Uruguay,6,0,0.17106,0.39894,8,draw,draw
United States,Canada,2,0,CONCACAF Championship qualification,United States,20,10,1976,2,-2,2,1377,0,0,United_States,Canada,6,2,0.69572,0.02165,8,winner,loser
Mexico,Canada,0,0,CONCACAF Championship qualification,Mexico,27,10,1976,0,0,0,1378,1,0,Mexico,Canada,6,0,0.0467,0.31083,8,draw,draw
Portugal,Denmark,1,0,FIFA World Cup qualification,Portugal,17,11,1976,1,-1,1,1379,1,1,Portugal,Denmark,6,1,0.32416,0.63233,8,winner,loser
Japan,South Korea,1,2,Friendly,Japan,4,12,1976,-1,1,3,1380,0,0,Japan,South_Korea,6,1,0.84165,0.57379,8,loser,winner
Morocco,Tunisia,1,1,FIFA World Cup qualification,Morocco,12,12,1976,0,0,2,1381,0,1,Morocco,Tunisia,6,0,0.96547,0.8249,8,draw,draw
Canada,United States,3,0,CONCACAF Championship qualification,Haiti,22,12,1976,3,-3,3,1382,0,0,Canada,United_States,6,3,0.87067,0.67983,8,winner,loser
Uruguay,Ecuador,1,1,Friendly,Uruguay,4,1,1977,0,0,2,1383,1,0,Uruguay,Ecuador,7,0,0.7686,0.36788,8,draw,draw
Saudi Arabia,Iran,0,3,FIFA World Cup qualification,Saudi Arabia,7,1,1977,-3,3,3,1384,1,1,Saudi_Arabia,Iran,7,3,0.3077,0.08549,8,loser,winner
Tunisia,Morocco,1,1,FIFA World Cup qualification,Tunisia,9,1,1977,0,0,2,1385,1,0,Tunisia,Morocco,7,0,0.22207,0.3153,8,draw,draw
Senegal,Denmark,2,3,Friendly,Senegal,2,2,1977,-1,1,5,1386,0,1,Senegal,Denmark,7,1,0.85785,0.13773,8,loser,winner
England,Netherlands,0,2,Friendly,England,9,2,1977,-2,2,2,1387,1,1,England,Netherlands,7,2,0.7124,0.70716,8,loser,winner
France,Germany,1,0,Friendly,France,23,2,1977,1,-1,1,1388,0,1,France,Germany,7,1,0.83556,0.10812,8,winner,loser
Qatar,Tunisia,1,0,Friendly,Qatar,8,3,1977,1,-1,1,1389,0,1,Qatar,Tunisia,7,1,0.617,0.34187,8,winner,loser
Argentina,Iran,1,1,Real Madrid 75th Anniversary Cup,Spain,22,3,1977,0,0,2,1390,1,1,Argentina,Iran,7,0,0.38525,0.11138,8,draw,draw
Belgium,Netherlands,0,2,FIFA World Cup qualification,Belgium,26,3,1977,-2,2,2,1391,1,1,Belgium,Netherlands,7,2,0.47977,0.92329,8,loser,winner
Japan,South Korea,0,0,FIFA World Cup qualification,Japan,26,3,1977,0,0,0,1392,0,0,Japan,South_Korea,7,0,0.9436,0.54372,8,draw,draw
Portugal,Switzerland,1,0,Friendly,Portugal,30,3,1977,1,-1,1,1393,1,0,Portugal,Switzerland,7,1,0.71635,0.93825,8,winner,loser
South Korea,Japan,1,0,FIFA World Cup qualification,South Korea,3,4,1977,1,-1,1,1394,0,0,South_Korea,Japan,7,1,0.09689,0.93015,8,winner,loser
Iran,Saudi Arabia,2,0,FIFA World Cup qualification,Iran,22,4,1977,2,-2,2,1395,1,1,Iran,Saudi_Arabia,7,2,0.47678,0.90074,8,winner,loser
Switzerland,France,0,4,Friendly,Switzerland,23,4,1977,-4,4,4,1396,0,0,Switzerland,France,7,4,0.62146,0.32479,8,loser,winner
Denmark,Poland,1,2,FIFA World Cup qualification,Denmark,1,5,1977,-1,1,3,1397,1,0,Denmark,Poland,7,1,0.20397,0.92045,8,loser,winner
Senegal,Morocco,3,2,Friendly,Senegal,28,5,1977,1,-1,5,1398,0,0,Senegal,Morocco,7,1,0.08122,0.42499,8,winner,loser
Argentina,Poland,3,1,Friendly,Argentina,29,5,1977,2,-2,4,1399,1,0,Argentina,Poland,7,2,0.95261,0.42511,8,winner,loser
England,Wales,0,1,British Championship,England,31,5,1977,-1,1,1,1400,1,0,England,Wales,7,1,0.5085,0.13963,8,loser,winner
Argentina,Germany,1,3,Friendly,Argentina,5,6,1977,-2,2,4,1401,1,1,Argentina,Germany,7,2,0.48049,0.02301,8,loser,winner
Brazil,England,0,0,Friendly,Brazil,8,6,1977,0,0,0,1402,0,1,Brazil,England,7,0,0.71262,0.72156,8,draw,draw
Uruguay,Germany,0,2,Friendly,Uruguay,8,6,1977,-2,2,2,1403,1,1,Uruguay,Germany,7,2,0.38461,0.52875,8,loser,winner
Argentina,England,1,1,Friendly,Argentina,12,6,1977,0,0,2,1404,1,1,Argentina,England,7,0,0.89191,0.20044,8,draw,draw
Brazil,Germany,1,1,Friendly,Brazil,12,6,1977,0,0,2,1405,0,1,Brazil,Germany,7,0,0.45718,0.22415,8,draw,draw
Mexico,Germany,2,2,Friendly,Mexico,14,6,1977,0,0,4,1406,1,1,Mexico,Germany,7,0,0.52913,0.37967,8,draw,draw
South Korea,Japan,2,1,Friendly,South Korea,15,6,1977,1,-1,3,1407,0,0,South_Korea,Japan,7,1,0.07599,0.08181,8,winner,loser
Uruguay,England,0,0,Friendly,Uruguay,15,6,1977,0,0,0,1408,1,1,Uruguay,England,7,0,0.16914,0.57819,8,draw,draw
Brazil,Poland,3,1,Friendly,Brazil,19,6,1977,2,-2,4,1409,0,0,Brazil,Poland,7,2,0.25763,0.98077,8,winner,loser
Argentina,France,0,0,Friendly,Argentina,26,6,1977,0,0,0,1410,1,0,Argentina,France,7,0,0.19312,0.47937,8,draw,draw
Brazil,France,2,2,Friendly,Brazil,30,6,1977,0,0,4,1411,0,0,Brazil,France,7,0,0.68463,0.50315,8,draw,draw
South Korea,Iran,0,0,FIFA World Cup qualification,South Korea,3,7,1977,0,0,0,1412,0,1,South_Korea,Iran,7,0,0.41848,0.78453,8,draw,draw
Iran,Morocco,1,1,Beijing International Friendship Tournament,China PR,27,7,1977,0,0,2,1413,1,0,Iran,Morocco,7,0,0.30768,0.99044,8,draw,draw
Australia,Iran,0,1,FIFA World Cup qualification,Australia,14,8,1977,-1,1,1,1414,0,1,Australia,Iran,7,1,0.34282,0.41593,8,loser,winner
Australia,South Korea,2,1,FIFA World Cup qualification,Australia,27,8,1977,1,-1,3,1415,0,0,Australia,South_Korea,7,1,0.99715,0.98568,8,winner,loser
England,Switzerland,0,0,Friendly,England,7,9,1977,0,0,0,1416,1,0,England,Switzerland,7,0,0.03337,0.24249,8,draw,draw
Poland,Denmark,4,1,FIFA World Cup qualification,Poland,21,9,1977,3,-3,5,1417,0,1,Poland,Denmark,7,3,0.854,0.07045,8,winner,loser
Switzerland,Spain,1,2,Friendly,Switzerland,21,9,1977,-1,1,3,1418,0,1,Switzerland,Spain,7,1,0.96443,0.77047,8,loser,winner
Mexico,United States,3,0,Friendly,Mexico,27,9,1977,3,-3,3,1419,1,0,Mexico,United_States,7,3,0.87987,0.39221,8,winner,loser
Denmark,Portugal,2,4,FIFA World Cup qualification,Denmark,9,10,1977,-2,2,6,1420,1,1,Denmark,Portugal,7,2,0.05112,0.34926,8,loser,winner
Mexico,Canada,3,1,CONCACAF Championship,Mexico,22,10,1977,2,-2,4,1421,1,0,Mexico,Canada,7,2,0.09743,0.3558,8,winner,loser
South Korea,Australia,0,0,FIFA World Cup qualification,South Korea,23,10,1977,0,0,0,1422,0,0,South_Korea,Australia,7,0,0.66241,0.37219,8,draw,draw
Netherlands,Belgium,1,0,FIFA World Cup qualification,Netherlands,26,10,1977,1,-1,1,1423,1,1,Netherlands,Belgium,7,1,0.99664,0.64963,8,winner,loser
Poland,Portugal,1,1,FIFA World Cup qualification,Poland,29,10,1977,0,0,2,1424,0,1,Poland,Portugal,7,0,0.8251,0.99892,8,draw,draw
Iran,South Korea,2,2,FIFA World Cup qualification,Iran,11,11,1977,0,0,4,1425,1,0,Iran,South_Korea,7,0,0.70624,0.09368,8,draw,draw
Germany,Switzerland,4,1,Friendly,Germany,16,11,1977,3,-3,5,1426,1,0,Germany,Switzerland,7,3,0.08533,0.81611,8,winner,loser
Iran,Australia,1,0,FIFA World Cup qualification,Iran,25,11,1977,1,-1,1,1427,1,0,Iran,Australia,7,1,0.64827,0.46281,8,winner,loser
Germany,Wales,1,1,Friendly,Germany,14,12,1977,0,0,2,1428,1,0,Germany,Wales,7,0,0.06399,0.13803,8,draw,draw
Germany,England,2,1,Friendly,Germany,22,2,1978,1,-1,3,1429,1,1,Germany,England,8,1,0.99588,0.68533,8,winner,loser
Morocco,Tunisia,1,1,African Cup of Nations,Ghana,6,3,1978,0,0,2,1430,0,1,Morocco,Tunisia,8,0,0.90793,0.47688,8,draw,draw
France,Portugal,2,0,Friendly,France,8,3,1978,2,-2,2,1431,0,1,France,Portugal,8,2,0.45315,0.42451,8,winner,loser
Ghana,Tunisia,1,0,African Cup of Nations,Ghana,14,3,1978,1,-1,1,1432,0,1,Ghana,Tunisia,8,1,0.4726,0.69839,8,winner,loser
France,Brazil,1,0,Friendly,France,1,4,1978,1,-1,1,1433,0,0,France,Brazil,8,1,0.45493,0.10326,8,winner,loser
Germany,Brazil,0,1,Friendly,Germany,5,4,1978,-1,1,1,1434,1,0,Germany,Brazil,8,1,0.0698,0.26014,8,loser,winner
Tunisia,Netherlands,0,4,Friendly,Tunisia,5,4,1978,-4,4,4,1435,1,1,Tunisia,Netherlands,8,4,0.11629,0.50792,8,loser,winner
Iran,Wales,0,1,Friendly,Iran,18,4,1978,-1,1,1,1436,1,0,Iran,Wales,8,1,0.70016,0.00333,8,loser,winner
England,Brazil,1,1,Friendly,England,19,4,1978,0,0,2,1437,1,0,England,Brazil,8,0,0.42619,0.0124,8,draw,draw
Uruguay,Argentina,2,0,Friendly,Uruguay,25,4,1978,2,-2,2,1438,1,1,Uruguay,Argentina,8,2,0.69422,0.93003,8,winner,loser
Spain,Mexico,2,0,Friendly,Spain,26,4,1978,2,-2,2,1439,1,1,Spain,Mexico,8,2,0.321,0.3827,8,winner,loser
Argentina,Uruguay,3,0,Friendly,Argentina,3,5,1978,3,-3,3,1440,1,1,Argentina,Uruguay,8,3,0.06813,0.02292,8,winner,loser
France,Iran,2,1,Friendly,France,11,5,1978,1,-1,3,1441,0,1,France,Iran,8,1,0.60642,0.69892,8,winner,loser
Wales,England,1,3,British Championship,Wales,13,5,1978,-2,2,4,1442,0,1,Wales,England,8,2,0.5693,0.26936,8,loser,winner
France,Tunisia,2,0,Friendly,France,19,5,1978,2,-2,2,1443,0,1,France,Tunisia,8,2,0.38699,0.38853,8,winner,loser
Iran,Ghana,3,0,Friendly,Iran,19,5,1978,3,-3,3,1444,1,0,Iran,Ghana,8,3,0.00602,0.10076,8,winner,loser
Uruguay,Spain,0,0,Friendly,Uruguay,24,5,1978,0,0,0,1445,1,1,Uruguay,Spain,8,0,0.31742,0.83638,8,draw,draw
Germany,Poland,0,0,FIFA World Cup,Argentina,1,6,1978,0,0,0,1446,1,0,Germany,Poland,8,0,0.96222,0.71354,8,draw,draw
Mexico,Tunisia,1,3,FIFA World Cup,Argentina,2,6,1978,-2,2,4,1447,1,1,Mexico,Tunisia,8,2,0.02832,0.18556,8,loser,winner
Iran,Netherlands,0,3,FIFA World Cup,Argentina,3,6,1978,-3,3,3,1448,1,1,Iran,Netherlands,8,3,0.96515,0.83259,8,loser,winner
Argentina,France,2,1,FIFA World Cup,Argentina,6,6,1978,1,-1,3,1449,1,0,Argentina,France,8,1,0.82269,0.89302,8,winner,loser
Germany,Mexico,6,0,FIFA World Cup,Argentina,6,6,1978,6,-6,6,1450,1,1,Germany,Mexico,8,6,0.34654,0.14046,8,winner,loser
Poland,Tunisia,1,0,FIFA World Cup,Argentina,6,6,1978,1,-1,1,1451,0,1,Poland,Tunisia,8,1,0.09965,0.01081,8,winner,loser
Brazil,Spain,0,0,FIFA World Cup,Argentina,7,6,1978,0,0,0,1452,0,1,Brazil,Spain,8,0,0.24901,0.48887,8,draw,draw
Germany,Tunisia,0,0,FIFA World Cup,Argentina,10,6,1978,0,0,0,1453,1,1,Germany,Tunisia,8,0,0.98799,0.43263,8,draw,draw
Mexico,Poland,1,3,FIFA World Cup,Argentina,10,6,1978,-2,2,4,1454,1,0,Mexico,Poland,8,2,0.66574,0.68279,8,loser,winner
Argentina,Poland,2,0,FIFA World Cup,Argentina,14,6,1978,2,-2,2,1455,1,0,Argentina,Poland,8,2,0.2569,0.8817,8,winner,loser
Argentina,Brazil,0,0,FIFA World Cup,Argentina,18,6,1978,0,0,0,1456,1,0,Argentina,Brazil,8,0,0.95213,0.18016,8,draw,draw
Germany,Netherlands,2,2,FIFA World Cup,Argentina,18,6,1978,0,0,4,1457,1,1,Germany,Netherlands,8,0,0.2155,0.10129,8,draw,draw
Brazil,Poland,3,1,FIFA World Cup,Argentina,21,6,1978,2,-2,4,1458,0,0,Brazil,Poland,8,2,0.70218,0.63056,8,winner,loser
Argentina,Netherlands,3,1,FIFA World Cup,Argentina,25,6,1978,2,-2,4,1459,1,1,Argentina,Netherlands,8,2,0.23567,0.22401,8,winner,loser
Japan,South Korea,0,4,Merdeka Tournament,Malaysia,19,7,1978,-4,4,4,1460,0,0,Japan,South_Korea,8,4,0.40337,0.39943,8,loser,winner
Switzerland,United States,2,0,Friendly,Switzerland,6,9,1978,2,-2,2,1461,0,0,Switzerland,United_States,8,2,0.25324,0.76052,8,winner,loser
Denmark,England,3,4,UEFA Euro qualification,Denmark,20,9,1978,-1,1,7,1462,1,1,Denmark,England,8,1,0.5217,0.34552,8,loser,winner
Portugal,United States,1,0,Friendly,Portugal,20,9,1978,1,-1,1,1463,1,0,Portugal,United_States,8,1,0.78663,0.01452,8,winner,loser
Portugal,Belgium,1,1,UEFA Euro qualification,Portugal,11,10,1978,0,0,2,1464,1,1,Portugal,Belgium,8,0,0.73096,0.7219,8,draw,draw
Switzerland,Netherlands,1,3,UEFA Euro qualification,Switzerland,11,10,1978,-2,2,4,1465,0,1,Switzerland,Netherlands,8,2,0.63752,0.97376,8,loser,winner
France,Spain,1,0,Friendly,France,8,11,1978,1,-1,1,1466,0,1,France,Spain,8,1,0.82297,0.74658,8,winner,loser
Poland,Switzerland,2,0,UEFA Euro qualification,Poland,15,11,1978,2,-2,2,1467,0,0,Poland,Switzerland,8,2,0.53153,0.91246,8,winner,loser
Germany,Netherlands,3,1,Friendly,Germany,20,12,1978,2,-2,4,1468,1,1,Germany,Netherlands,8,2,0.40138,0.47047,8,winner,loser
Tunisia,Poland,0,2,Friendly,Tunisia,18,2,1979,-2,2,2,1469,1,0,Tunisia,Poland,9,2,0.23924,0.12547,8,loser,winner
Japan,South Korea,2,1,Friendly,Japan,4,3,1979,1,-1,3,1470,0,0,Japan,South_Korea,9,1,0.38351,0.30098,8,winner,loser
Netherlands,Switzerland,3,0,UEFA Euro qualification,Netherlands,28,3,1979,3,-3,3,1471,1,0,Netherlands,Switzerland,9,3,0.86093,0.8635,8,winner,loser
Saudi Arabia,Qatar,7,0,Gulf Cup,Iraq,4,4,1979,7,-7,7,1472,1,0,Saudi_Arabia,Qatar,9,7,0.61677,0.84476,8,winner,loser
Poland,Netherlands,2,0,UEFA Euro qualification,Poland,2,5,1979,2,-2,2,1473,0,1,Poland,Netherlands,9,2,0.55934,0.52178,8,winner,loser
United States,France,0,6,Friendly,United States,2,5,1979,-6,6,6,1474,0,0,United_States,France,9,6,0.31708,0.72522,8,loser,winner
Wales,Germany,0,2,UEFA Euro qualification,Wales,2,5,1979,-2,2,2,1475,0,1,Wales,Germany,9,2,0.76411,0.30747,8,loser,winner
Argentina,Netherlands,0,0,FIFA 75th Anniversary Cup,Switzerland,22,5,1979,0,0,0,1476,1,1,Argentina,Netherlands,9,0,0.27779,0.29353,8,draw,draw
England,Wales,0,0,British Championship,England,23,5,1979,0,0,0,1477,1,0,England,Wales,9,0,0.69373,0.78042,8,draw,draw
Brazil,Uruguay,5,1,Friendly,Brazil,31,5,1979,4,-4,6,1478,0,1,Brazil,Uruguay,9,4,0.20486,0.55738,8,winner,loser
South Korea,Japan,4,1,Friendly,South Korea,16,6,1979,3,-3,5,1479,0,0,South_Korea,Japan,9,3,0.17636,0.08277,8,winner,loser
Brazil,Argentina,2,1,Copa America,Brazil,2,8,1979,1,-1,3,1480,0,1,Brazil,Argentina,9,1,0.14909,0.96987,8,winner,loser
Argentina,Brazil,2,2,Copa America,Argentina,23,8,1979,0,0,4,1481,1,0,Argentina,Brazil,9,0,0.70376,0.82825,8,draw,draw
Ecuador,Uruguay,2,1,Copa America,Ecuador,5,9,1979,1,-1,3,1482,0,1,Ecuador,Uruguay,9,1,0.57697,0.26248,8,winner,loser
England,Denmark,1,0,UEFA Euro qualification,England,12,9,1979,1,-1,1,1483,1,1,England,Denmark,9,1,0.06761,0.75737,8,winner,loser
Germany,Argentina,2,1,Friendly,Germany,12,9,1979,1,-1,3,1484,1,1,Germany,Argentina,9,1,0.00129,0.29159,8,winner,loser
Switzerland,Poland,0,2,UEFA Euro qualification,Switzerland,12,9,1979,-2,2,2,1485,0,0,Switzerland,Poland,9,2,0.08407,0.75475,8,loser,winner
Uruguay,Ecuador,2,1,Copa America,Uruguay,16,9,1979,1,-1,3,1486,1,0,Uruguay,Ecuador,9,1,0.59461,0.71262,8,winner,loser
Netherlands,Belgium,1,0,Friendly,Netherlands,26,9,1979,1,-1,1,1487,1,1,Netherlands,Belgium,9,1,0.63838,0.47848,8,winner,loser
Spain,Portugal,1,1,Friendly,Spain,26,9,1979,0,0,2,1488,1,1,Spain,Portugal,9,0,0.79624,0.47423,8,draw,draw
France,United States,3,0,Friendly,France,10,10,1979,3,-3,3,1489,0,0,France,United_States,9,3,0.48114,0.44904,8,winner,loser
Belgium,Portugal,2,0,UEFA Euro qualification,Belgium,17,10,1979,2,-2,2,1490,1,1,Belgium,Portugal,9,2,0.00298,0.96466,8,winner,loser
Germany,Wales,5,1,UEFA Euro qualification,Germany,17,10,1979,4,-4,6,1491,1,0,Germany,Wales,9,4,0.53321,0.85308,8,winner,loser
Netherlands,Poland,1,1,UEFA Euro qualification,Netherlands,17,10,1979,0,0,2,1492,1,0,Netherlands,Poland,9,0,0.71226,0.06226,8,draw,draw
Spain,Denmark,1,3,Friendly,Spain,14,11,1979,-2,2,4,1493,1,1,Spain,Denmark,9,2,0.08999,0.38028,8,loser,winner
Tunisia,Senegal,3,1,Friendly,Tunisia,26,12,1979,2,-2,4,1494,1,0,Tunisia,Senegal,9,2,0.7301,0.7406,8,winner,loser
Spain,Netherlands,1,0,Friendly,Spain,23,1,1980,1,-1,1,1495,1,1,Spain,Netherlands,0,1,0.05816,0.2983,9,winner,loser
Ghana,Tunisia,4,1,Friendly,Ghana,27,1,1980,3,-3,5,1496,0,1,Ghana,Tunisia,0,3,0.14702,0.27021,9,winner,loser
Saudi Arabia,South Korea,1,3,Friendly,Saudi Arabia,30,1,1980,-2,2,4,1497,1,0,Saudi_Arabia,South_Korea,0,2,0.51695,0.36063,9,loser,winner
Saudi Arabia,South Korea,0,0,Friendly,Saudi Arabia,1,2,1980,0,0,0,1498,1,0,Saudi_Arabia,South_Korea,0,0,0.07736,0.57491,9,draw,draw
Morocco,Poland,1,0,Friendly,Morocco,17,2,1980,1,-1,1,1499,0,0,Morocco,Poland,0,1,0.39214,0.40075,9,winner,loser
Morocco,Senegal,3,2,Friendly,Morocco,25,2,1980,1,-1,5,1500,0,0,Morocco,Senegal,0,1,0.01006,0.06414,9,winner,loser
Mexico,South Korea,0,1,Friendly,United States,26,2,1980,-1,1,1,1501,1,0,Mexico,South_Korea,0,1,0.14079,0.60039,9,loser,winner
Morocco,Tunisia,0,0,Friendly,Morocco,27,2,1980,0,0,0,1502,0,1,Morocco,Tunisia,0,0,0.4656,0.39295,9,draw,draw
Ghana,Morocco,0,1,African Cup of Nations,Nigeria,16,3,1980,-1,1,1,1503,0,0,Ghana,Morocco,0,1,0.2967,0.92507,9,loser,winner
Belgium,Uruguay,2,0,Friendly,Belgium,18,3,1980,2,-2,2,1504,1,1,Belgium,Uruguay,0,2,0.23294,0.69454,9,winner,loser
France,Netherlands,0,0,Friendly,France,26,3,1980,0,0,0,1505,0,1,France,Netherlands,0,0,0.26302,0.61589,9,draw,draw
Spain,England,0,2,Friendly,Spain,26,3,1980,-2,2,2,1506,1,1,Spain,England,0,2,0.92774,0.55499,9,loser,winner
Belgium,Poland,2,1,Friendly,Belgium,2,4,1980,1,-1,3,1507,1,0,Belgium,Poland,0,1,0.99403,0.48212,9,winner,loser
Senegal,Tunisia,0,2,Friendly,Senegal,5,4,1980,-2,2,2,1508,0,1,Senegal,Tunisia,0,2,0.98774,0.1703,9,loser,winner
England,Argentina,3,1,Friendly,England,13,5,1980,2,-2,4,1509,1,1,England,Argentina,0,2,0.93377,0.84345,9,winner,loser
Germany,Poland,3,1,Friendly,Germany,13,5,1980,2,-2,4,1510,1,0,Germany,Poland,0,2,0.96327,0.87369,9,winner,loser
Wales,England,4,1,British Championship,Wales,17,5,1980,3,-3,5,1511,0,1,Wales,England,0,3,0.36811,0.46645,9,winner,loser
Denmark,Spain,2,2,Friendly,Denmark,21,5,1980,0,0,4,1512,1,1,Denmark,Spain,0,0,0.21905,0.60675,9,draw,draw
Australia,England,1,2,Friendly,Australia,31,5,1980,-1,1,3,1513,0,1,Australia,England,0,1,0.08701,0.64515,9,loser,winner
Brazil,Mexico,2,0,Friendly,Brazil,8,6,1980,2,-2,2,1514,0,1,Brazil,Mexico,0,2,0.05834,0.1372,9,winner,loser
Tunisia,Morocco,0,1,Friendly,Tunisia,8,6,1980,-1,1,1,1515,1,0,Tunisia,Morocco,0,1,0.77191,0.51774,9,loser,winner
Belgium,England,1,1,UEFA Euro,Italy,12,6,1980,0,0,2,1516,1,1,Belgium,England,0,0,0.76456,0.0603,9,draw,draw
Germany,Netherlands,3,2,UEFA Euro,Italy,14,6,1980,1,-1,5,1517,1,1,Germany,Netherlands,0,1,0.70325,0.6594,9,winner,loser
Belgium,Spain,2,1,UEFA Euro,Italy,15,6,1980,1,-1,3,1518,1,1,Belgium,Spain,0,1,0.18472,0.38479,9,winner,loser
Spain,England,1,2,UEFA Euro,Italy,18,6,1980,-1,1,3,1519,1,1,Spain,England,0,1,0.76676,0.01237,9,loser,winner
Belgium,Germany,1,2,UEFA Euro,Italy,22,6,1980,-1,1,3,1520,1,1,Belgium,Germany,0,1,0.30635,0.10943,9,loser,winner
Senegal,Morocco,0,1,FIFA World Cup qualification,Senegal,22,6,1980,-1,1,1,1521,0,0,Senegal,Morocco,0,1,0.51262,0.49007,9,loser,winner
Brazil,Poland,1,1,Friendly,Brazil,29,6,1980,0,0,2,1522,0,0,Brazil,Poland,0,0,0.29381,0.65033,9,draw,draw
Morocco,Senegal,0,0,FIFA World Cup qualification,Morocco,6,7,1980,0,0,0,1523,0,0,Morocco,Senegal,0,0,0.37473,0.51075,9,draw,draw
Australia,Mexico,2,2,Friendly,Australia,24,8,1980,0,0,4,1524,0,1,Australia,Mexico,0,0,0.45761,0.98697,9,draw,draw
Australia,Mexico,1,1,Friendly,Australia,26,8,1980,0,0,2,1525,0,1,Australia,Mexico,0,0,0.06097,0.44293,9,draw,draw
Brazil,Uruguay,1,0,Friendly,Brazil,27,8,1980,1,-1,1,1526,0,1,Brazil,Uruguay,0,1,0.57886,0.47011,9,winner,loser
Switzerland,Denmark,1,1,Friendly,Switzerland,27,8,1980,0,0,2,1527,0,1,Switzerland,Denmark,0,0,0.64228,0.79432,9,draw,draw
Switzerland,Germany,2,3,Friendly,Switzerland,10,9,1980,-1,1,5,1528,0,1,Switzerland,Germany,0,1,0.67727,0.30999,9,loser,winner
Qatar,South Korea,0,2,AFC Asian Cup,Kuwait,19,9,1980,-2,2,2,1529,0,0,Qatar,South_Korea,0,2,0.29216,0.31153,9,loser,winner
Portugal,United States,1,1,Friendly,Portugal,7,10,1980,0,0,2,1530,1,0,Portugal,United_States,0,0,0.02924,0.65915,9,draw,draw
Netherlands,Germany,1,1,Friendly,Netherlands,11,10,1980,0,0,2,1531,1,1,Netherlands,Germany,0,0,0.80648,0.62511,9,draw,draw
Argentina,Poland,2,1,Friendly,Argentina,12,10,1980,1,-1,3,1532,1,0,Argentina,Poland,0,1,0.27047,0.60678,9,winner,loser
Canada,Mexico,1,1,CONCACAF Championship qualification,Canada,18,10,1980,0,0,2,1533,0,1,Canada,Mexico,0,0,0.33918,0.61777,9,draw,draw
South Korea,Morocco,1,1,Merdeka Tournament,Malaysia,20,10,1980,0,0,2,1534,0,0,South_Korea,Morocco,0,0,0.89051,0.04614,9,draw,draw
United States,Canada,0,0,CONCACAF Championship qualification,United States,25,10,1980,0,0,0,1535,0,0,United_States,Canada,0,0,0.20989,0.63478,9,draw,draw
Canada,United States,2,1,CONCACAF Championship qualification,Canada,1,11,1980,1,-1,3,1536,0,0,Canada,United_States,0,1,0.1852,0.76905,9,winner,loser
Mexico,United States,5,1,CONCACAF Championship qualification,Mexico,9,11,1980,4,-4,6,1537,1,0,Mexico,United_States,0,4,0.44911,0.98303,9,winner,loser
Spain,Poland,1,2,Friendly,Spain,12,11,1980,-1,1,3,1538,1,0,Spain,Poland,0,1,0.85858,0.49528,9,loser,winner
Mexico,Canada,1,1,CONCACAF Championship qualification,Mexico,16,11,1980,0,0,2,1539,1,0,Mexico,Canada,0,0,0.98924,0.7257,9,draw,draw
Belgium,Netherlands,1,0,FIFA World Cup qualification,Belgium,19,11,1980,1,-1,1,1540,1,1,Belgium,Netherlands,0,1,0.79005,0.26139,9,winner,loser
England,Switzerland,2,1,FIFA World Cup qualification,England,19,11,1980,1,-1,3,1541,1,0,England,Switzerland,0,1,0.40013,0.24457,9,winner,loser
Germany,France,4,1,Friendly,Germany,19,11,1980,3,-3,5,1542,1,0,Germany,France,0,3,0.90322,0.6427,9,winner,loser
United States,Mexico,2,1,CONCACAF Championship qualification,United States,23,11,1980,1,-1,3,1543,0,1,United_States,Mexico,0,1,0.51924,0.08971,9,winner,loser
Argentina,Switzerland,5,0,Friendly,Argentina,16,12,1980,5,-5,5,1544,1,0,Argentina,Switzerland,0,5,0.56215,0.65668,9,winner,loser
Uruguay,Switzerland,4,0,Friendly,Uruguay,18,12,1980,4,-4,4,1545,1,0,Uruguay,Switzerland,0,4,0.51564,0.91346,9,winner,loser
Brazil,Switzerland,2,0,Friendly,Brazil,21,12,1980,2,-2,2,1546,0,0,Brazil,Switzerland,0,2,0.70066,0.59129,9,winner,loser
Uruguay,Netherlands,2,0,Mundialito,Uruguay,30,12,1980,2,-2,2,1547,1,1,Uruguay,Netherlands,0,2,0.75565,0.21817,9,winner,loser
Argentina,Germany,2,1,Mundialito,Uruguay,1,1,1981,1,-1,3,1548,1,1,Argentina,Germany,1,1,0.58956,0.32654,9,winner,loser
Argentina,Brazil,1,1,Mundialito,Uruguay,4,1,1981,0,0,2,1549,1,0,Argentina,Brazil,1,0,0.76094,0.42676,9,draw,draw
Brazil,Germany,4,1,Mundialito,Uruguay,7,1,1981,3,-3,5,1550,0,1,Brazil,Germany,1,3,0.77307,0.17769,9,winner,loser
Uruguay,Brazil,2,1,Mundialito,Uruguay,10,1,1981,1,-1,3,1551,1,0,Uruguay,Brazil,1,1,0.09213,0.73003,9,winner,loser
Tunisia,Qatar,4,0,Friendly,Tunisia,11,1,1981,4,-4,4,1552,1,0,Tunisia,Qatar,1,4,0.5775,0.3951,9,winner,loser
Japan,Poland,0,2,Friendly,Japan,25,1,1981,-2,2,2,1553,0,0,Japan,Poland,1,2,0.04545,0.80535,9,loser,winner
Japan,Poland,2,4,Friendly,Japan,27,1,1981,-2,2,6,1554,0,0,Japan,Poland,1,2,0.79621,0.77647,9,loser,winner
Japan,Poland,1,4,Friendly,Japan,30,1,1981,-3,3,5,1555,0,0,Japan,Poland,1,3,0.86987,0.99188,9,loser,winner
Japan,Poland,0,3,Friendly,Japan,1,2,1981,-3,3,3,1556,0,0,Japan,Poland,1,3,0.29252,0.13577,9,loser,winner
Mexico,South Korea,4,0,Friendly,Mexico,11,2,1981,4,-4,4,1557,1,0,Mexico,South_Korea,1,4,0.17481,0.52616,9,winner,loser
Ecuador,Brazil,0,6,Friendly,Ecuador,14,2,1981,-6,6,6,1558,0,0,Ecuador,Brazil,1,6,0.69031,0.3056,9,loser,winner
Spain,France,1,0,Friendly,Spain,18,2,1981,1,-1,1,1559,1,0,Spain,France,1,1,0.58005,0.82666,9,winner,loser
Japan,South Korea,0,1,Friendly,Japan,8,3,1981,-1,1,1,1560,0,0,Japan,South_Korea,1,1,0.20582,0.46356,9,loser,winner
Saudi Arabia,Tunisia,1,2,Friendly,Saudi Arabia,8,3,1981,-1,1,3,1561,1,1,Saudi_Arabia,Tunisia,1,1,0.93906,0.64351,9,loser,winner
England,Spain,1,2,Friendly,England,25,3,1981,-1,1,3,1562,1,1,England,Spain,1,1,0.89465,0.7733,9,loser,winner
Netherlands,France,1,0,FIFA World Cup qualification,Netherlands,25,3,1981,1,-1,1,1563,1,0,Netherlands,France,1,1,0.097,0.08738,9,winner,loser
Saudi Arabia,Qatar,1,0,FIFA World Cup qualification,Saudi Arabia,31,3,1981,1,-1,1,1564,1,0,Saudi_Arabia,Qatar,1,1,0.36106,0.10669,9,winner,loser
Tunisia,Senegal,1,0,African Cup of Nations qualification,Tunisia,12,4,1981,1,-1,1,1565,1,0,Tunisia,Senegal,1,1,0.64649,0.27695,9,winner,loser
Senegal,Tunisia,0,0,African Cup of Nations qualification,Senegal,26,4,1981,0,0,0,1566,0,1,Senegal,Tunisia,1,0,0.92511,0.41482,9,draw,draw
France,Belgium,3,2,FIFA World Cup qualification,France,29,4,1981,1,-1,5,1567,0,1,France,Belgium,1,1,0.2543,0.20947,9,winner,loser
England,Brazil,0,1,Friendly,England,12,5,1981,-1,1,1,1568,1,0,England,Brazil,1,1,0.86956,0.73895,9,loser,winner
France,Brazil,1,3,Friendly,France,15,5,1981,-2,2,4,1569,0,0,France,Brazil,1,2,0.0926,0.12227,9,loser,winner
Germany,Brazil,1,2,Friendly,Germany,19,5,1981,-1,1,3,1570,1,0,Germany,Brazil,1,1,0.68142,0.30126,9,loser,winner
England,Wales,0,0,British Championship,England,20,5,1981,0,0,0,1571,1,0,England,Wales,1,0,0.76408,0.04584,9,draw,draw
Switzerland,England,2,1,FIFA World Cup qualification,Switzerland,30,5,1981,1,-1,3,1572,0,1,Switzerland,England,1,1,0.60668,0.97363,9,winner,loser
Portugal,Spain,2,0,Friendly,Portugal,20,6,1981,2,-2,2,1573,1,1,Portugal,Spain,1,2,0.03511,0.16215,9,winner,loser
South Korea,Japan,2,0,Korea Cup,South Korea,21,6,1981,2,-2,2,1574,0,0,South_Korea,Japan,1,2,0.6606,0.07207,9,winner,loser
Brazil,Spain,1,0,Friendly,Brazil,8,7,1981,1,-1,1,1575,0,1,Brazil,Spain,1,1,0.99118,0.20009,9,winner,loser
Switzerland,Netherlands,2,1,Friendly,Switzerland,1,9,1981,1,-1,3,1576,0,1,Switzerland,Netherlands,1,1,0.69533,0.06122,9,winner,loser
Poland,Germany,0,2,Friendly,Poland,2,9,1981,-2,2,2,1577,0,1,Poland,Germany,1,2,0.52422,0.44421,9,loser,winner
Belgium,France,2,0,FIFA World Cup qualification,Belgium,9,9,1981,2,-2,2,1578,1,0,Belgium,France,1,2,0.28265,0.32901,9,winner,loser
Portugal,Poland,2,0,Friendly,Portugal,23,9,1981,2,-2,2,1579,1,0,Portugal,Poland,1,2,0.68012,0.70838,9,winner,loser
Morocco,Tunisia,2,2,Friendly,Morocco,27,9,1981,0,0,4,1580,0,1,Morocco,Tunisia,1,0,0.4328,0.30801,9,draw,draw
Netherlands,Belgium,3,0,FIFA World Cup qualification,Netherlands,14,10,1981,3,-3,3,1581,1,1,Netherlands,Belgium,1,3,0.18598,0.73742,9,winner,loser
Saudi Arabia,South Korea,2,0,Friendly,Saudi Arabia,17,10,1981,2,-2,2,1582,1,0,Saudi_Arabia,South_Korea,1,2,0.69238,0.41092,9,winner,loser
Argentina,Poland,1,2,Friendly,Argentina,28,10,1981,-1,1,3,1583,1,0,Argentina,Poland,1,1,0.93502,0.09826,9,loser,winner
Senegal,Morocco,2,0,Friendly,Senegal,1,11,1981,2,-2,2,1584,0,0,Senegal,Morocco,1,2,0.84579,0.12627,9,winner,loser
Tunisia,Cameroon,1,1,Friendly,Tunisia,8,11,1981,0,0,2,1585,1,1,Tunisia,Cameroon,1,0,0.29505,0.42767,9,draw,draw
Mexico,Canada,1,1,CONCACAF Championship,Honduras,15,11,1981,0,0,2,1586,1,0,Mexico,Canada,1,0,0.56811,0.11447,9,draw,draw
Morocco,Cameroon,0,2,FIFA World Cup qualification,Morocco,15,11,1981,-2,2,2,1587,0,1,Morocco,Cameroon,1,2,0.65057,0.25811,9,loser,winner
France,Netherlands,2,0,FIFA World Cup qualification,France,18,11,1981,2,-2,2,1588,0,1,France,Netherlands,1,2,0.04419,0.10508,9,winner,loser
Poland,Spain,2,3,Friendly,Poland,18,11,1981,-1,1,5,1589,0,1,Poland,Spain,1,1,0.38045,0.477,9,loser,winner
Cameroon,Morocco,2,1,FIFA World Cup qualification,Cameroon,29,11,1981,1,-1,3,1590,1,0,Cameroon,Morocco,1,1,0.79745,0.03525,9,winner,loser
Spain,Belgium,2,0,Friendly,Spain,16,12,1981,2,-2,2,1591,1,1,Spain,Belgium,1,2,0.99041,0.20002,9,winner,loser
Germany,Portugal,3,1,Friendly,Germany,17,2,1982,2,-2,4,1592,1,1,Germany,Portugal,2,2,0.92277,0.46456,9,winner,loser
South Korea,Uruguay,2,2,Nehru Cup,India,20,2,1982,0,0,4,1593,0,1,South_Korea,Uruguay,2,0,0.07572,0.99507,9,draw,draw
Cameroon,Tunisia,1,1,African Cup of Nations,Libya,5,3,1982,0,0,2,1594,1,1,Cameroon,Tunisia,2,0,0.9882,0.65342,9,draw,draw
Cameroon,Ghana,0,0,African Cup of Nations,Libya,9,3,1982,0,0,0,1595,1,0,Cameroon,Ghana,2,0,0.6537,0.54661,9,draw,draw
Ghana,Tunisia,1,0,African Cup of Nations,Libya,12,3,1982,1,-1,1,1596,0,1,Ghana,Tunisia,2,1,0.65921,0.95443,9,winner,loser
Brazil,Germany,1,0,Friendly,Brazil,21,3,1982,1,-1,1,1597,0,1,Brazil,Germany,2,1,0.18535,0.68894,9,winner,loser
South Korea,Japan,3,0,Friendly,South Korea,21,3,1982,3,-3,3,1598,0,0,South_Korea,Japan,2,3,0.75532,0.28249,9,winner,loser
Argentina,Germany,1,1,Friendly,Argentina,24,3,1982,0,0,2,1599,1,1,Argentina,Germany,2,0,0.46639,0.6142,9,draw,draw
Spain,Wales,1,1,Friendly,Spain,24,3,1982,0,0,2,1600,1,0,Spain,Wales,2,0,0.73444,0.54133,9,draw,draw
Switzerland,Portugal,2,1,Friendly,Switzerland,24,3,1982,1,-1,3,1601,0,1,Switzerland,Portugal,2,1,0.76385,0.04218,9,winner,loser
Saudi Arabia,Qatar,1,0,Gulf Cup,United Arab Emirates,29,3,1982,1,-1,1,1602,1,0,Saudi_Arabia,Qatar,2,1,0.23578,0.69998,9,winner,loser
Wales,England,0,1,British Championship,Wales,27,4,1982,-1,1,1,1603,0,1,Wales,England,2,1,0.76193,0.09017,9,loser,winner
Spain,Switzerland,2,0,Friendly,Spain,28,4,1982,2,-2,2,1604,1,0,Spain,Switzerland,2,2,0.13853,0.19434,9,winner,loser
Cameroon,Senegal,2,1,Friendly,Cameroon,1,5,1982,1,-1,3,1605,1,0,Cameroon,Senegal,2,1,0.0356,0.78357,9,winner,loser
Ghana,Senegal,0,0,Friendly,Cameroon,4,5,1982,0,0,0,1606,0,0,Ghana,Senegal,2,0,0.81164,0.84287,9,draw,draw
Brazil,Portugal,3,1,Friendly,Brazil,5,5,1982,2,-2,4,1607,0,1,Brazil,Portugal,2,2,0.27583,0.1461,9,winner,loser
Cameroon,Ghana,0,0,Friendly,Cameroon,5,5,1982,0,0,0,1608,1,0,Cameroon,Ghana,2,0,0.51437,0.19989,9,draw,draw
Morocco,Senegal,2,1,Friendly,Morocco,12,5,1982,1,-1,3,1609,0,0,Morocco,Senegal,2,1,0.34022,0.0717,9,winner,loser
Brazil,Switzerland,1,1,Friendly,Brazil,19,5,1982,0,0,2,1610,0,0,Brazil,Switzerland,2,0,0.69676,0.37536,9,draw,draw
England,Netherlands,2,0,Friendly,England,25,5,1982,2,-2,2,1611,1,1,England,Netherlands,2,2,0.59717,0.40312,9,winner,loser
Denmark,Belgium,1,0,Friendly,Denmark,27,5,1982,1,-1,1,1612,1,1,Denmark,Belgium,2,1,0.28019,0.72562,9,winner,loser
France,Wales,0,1,Friendly,France,2,6,1982,-1,1,1,1613,0,0,France,Wales,2,1,0.918,0.49622,9,loser,winner
Argentina,Belgium,0,1,FIFA World Cup,Spain,13,6,1982,-1,1,1,1614,1,1,Argentina,Belgium,2,1,0.62136,0.05172,9,loser,winner
England,France,3,1,FIFA World Cup,Spain,16,6,1982,2,-2,4,1615,1,0,England,France,2,2,0.05612,0.32456,9,winner,loser
Poland,Cameroon,0,0,FIFA World Cup,Spain,19,6,1982,0,0,0,1616,0,1,Poland,Cameroon,2,0,0.76139,0.93233,9,draw,draw
Poland,Belgium,3,0,FIFA World Cup,Spain,28,6,1982,3,-3,3,1617,0,1,Poland,Belgium,2,3,0.13603,0.26719,9,winner,loser
Germany,England,0,0,FIFA World Cup,Spain,29,6,1982,0,0,0,1618,1,1,Germany,England,2,0,0.1429,0.66374,9,draw,draw
Argentina,Brazil,1,3,FIFA World Cup,Spain,2,7,1982,-2,2,4,1619,1,0,Argentina,Brazil,2,2,0.65036,0.68029,9,loser,winner
Spain,Germany,1,2,FIFA World Cup,Spain,2,7,1982,-1,1,3,1620,1,1,Spain,Germany,2,1,0.52948,0.97284,9,loser,winner
Spain,England,0,0,FIFA World Cup,Spain,5,7,1982,0,0,0,1621,1,1,Spain,England,2,0,0.92171,0.21073,9,draw,draw
Germany,France,3,3,FIFA World Cup,Spain,8,7,1982,0,0,6,1622,1,0,Germany,France,2,0,0.11102,0.20205,9,draw,draw
Poland,France,3,2,FIFA World Cup,Spain,10,7,1982,1,-1,5,1623,0,0,Poland,France,2,1,0.54562,0.63966,9,winner,loser
South Korea,Senegal,0,2,Merdeka Tournament,Malaysia,6,8,1982,-2,2,2,1624,0,0,South_Korea,Senegal,2,2,0.71605,0.31139,9,loser,winner
Ghana,Senegal,2,2,Merdeka Tournament,Malaysia,20,8,1982,0,0,4,1625,0,0,Ghana,Senegal,2,0,0.81422,0.24941,9,draw,draw
France,Poland,0,4,Friendly,France,31,8,1982,-4,4,4,1626,0,0,France,Poland,2,4,0.2668,0.81679,9,loser,winner
Denmark,England,2,2,UEFA Euro qualification,Denmark,22,9,1982,0,0,4,1627,1,1,Denmark,England,2,0,0.45047,0.68446,9,draw,draw
Germany,Belgium,0,0,Friendly,Germany,22,9,1982,0,0,0,1628,1,1,Germany,Belgium,2,0,0.73302,0.64233,9,draw,draw
Saudi Arabia,Morocco,2,1,Friendly,Saudi Arabia,3,10,1982,1,-1,3,1629,1,0,Saudi_Arabia,Morocco,2,1,0.98513,0.10697,9,winner,loser
Belgium,Switzerland,3,0,UEFA Euro qualification,Belgium,6,10,1982,3,-3,3,1630,1,0,Belgium,Switzerland,2,3,0.52361,0.05693,9,winner,loser
Portugal,Poland,2,1,UEFA Euro qualification,Portugal,10,10,1982,1,-1,3,1631,1,0,Portugal,Poland,2,1,0.0174,0.77185,9,winner,loser
Saudi Arabia,Cameroon,0,0,Friendly,Saudi Arabia,12,10,1982,0,0,0,1632,1,1,Saudi_Arabia,Cameroon,2,0,0.7537,0.35338,9,draw,draw
England,Germany,1,2,Friendly,England,13,10,1982,-1,1,3,1633,1,1,England,Germany,2,1,0.23017,0.55742,9,loser,winner
Netherlands,France,1,2,Friendly,Netherlands,10,11,1982,-1,1,3,1634,1,0,Netherlands,France,2,1,0.40887,0.42263,9,loser,winner
Portugal,France,0,3,Friendly,Portugal,16,2,1983,-3,3,3,1635,1,0,Portugal,France,3,3,0.24528,0.80608,9,loser,winner
Spain,Netherlands,1,0,UEFA Euro qualification,Spain,16,2,1983,1,-1,1,1636,1,1,Spain,Netherlands,3,1,0.73025,0.0211,9,winner,loser
England,Wales,2,1,British Championship,England,23,2,1983,1,-1,3,1637,1,0,England,Wales,3,1,0.92463,0.78684,9,winner,loser
Portugal,Germany,1,0,Friendly,Portugal,23,2,1983,1,-1,1,1638,1,1,Portugal,Germany,3,1,0.85771,0.02132,9,winner,loser
Japan,South Korea,1,1,Friendly,Japan,6,3,1983,0,0,2,1639,0,0,Japan,South_Korea,3,0,0.87741,0.91166,9,draw,draw
Senegal,Morocco,1,0,Friendly,Senegal,9,3,1983,1,-1,1,1640,0,0,Senegal,Morocco,3,1,0.60592,0.53265,9,winner,loser
Senegal,Morocco,0,0,Friendly,Senegal,10,3,1983,0,0,0,1641,0,0,Senegal,Morocco,3,0,0.95839,0.8139,9,draw,draw
Costa Rica,Mexico,0,1,Friendly,Costa Rica,15,3,1983,-1,1,1,1642,1,1,Costa_Rica,Mexico,3,1,0.84999,0.3321,9,loser,winner
Mexico,Costa Rica,1,0,Friendly,Mexico,22,3,1983,1,-1,1,1643,1,1,Mexico,Costa_Rica,3,1,0.63633,0.43171,9,winner,loser
Tunisia,Morocco,1,0,Friendly,Tunisia,23,3,1983,1,-1,1,1644,1,0,Tunisia,Morocco,3,1,0.37639,0.93445,9,winner,loser
Belgium,France,1,1,Friendly,Luxembourg,31,5,1983,0,0,2,1645,1,0,Belgium,France,3,0,0.86944,0.40881,9,draw,draw
Portugal,Brazil,0,4,Friendly,Portugal,8,6,1983,-4,4,4,1646,1,0,Portugal,Brazil,3,4,0.97819,0.18618,9,loser,winner
Australia,England,0,0,Friendly,Australia,12,6,1983,0,0,0,1647,0,1,Australia,England,3,0,0.05283,0.48287,9,draw,draw
Wales,Brazil,1,1,Friendly,Wales,12,6,1983,0,0,2,1648,0,0,Wales,Brazil,3,0,0.52795,0.56424,9,draw,draw
Australia,England,0,1,Friendly,Australia,15,6,1983,-1,1,1,1649,0,1,Australia,England,3,1,0.21378,0.34157,9,loser,winner
South Korea,Ghana,1,0,Korea Cup,South Korea,15,6,1983,1,-1,1,1650,0,0,South_Korea,Ghana,3,1,0.47771,0.93594,9,winner,loser
Switzerland,Brazil,1,2,Friendly,Switzerland,17,6,1983,-1,1,3,1651,0,0,Switzerland,Brazil,3,1,0.70996,0.74218,9,loser,winner
Australia,England,1,1,Friendly,Australia,19,6,1983,0,0,2,1652,0,1,Australia,England,3,0,0.00309,0.28133,9,draw,draw
Costa Rica,South Korea,1,1,Friendly,Costa Rica,9,8,1983,0,0,2,1653,1,0,Costa_Rica,South_Korea,3,0,0.89372,0.96019,9,draw,draw
Ecuador,Argentina,2,2,Copa America,Ecuador,10,8,1983,0,0,4,1654,0,1,Ecuador,Argentina,3,0,0.4755,0.71353,9,draw,draw
Ecuador,Brazil,0,1,Copa America,Ecuador,17,8,1983,-1,1,1,1655,0,0,Ecuador,Brazil,3,1,0.97638,0.47619,9,loser,winner
Argentina,Brazil,1,0,Copa America,Argentina,24,8,1983,1,-1,1,1656,1,0,Argentina,Brazil,3,1,0.65769,0.52365,9,winner,loser
Brazil,Ecuador,5,0,Copa America,Brazil,1,9,1983,5,-5,5,1657,0,0,Brazil,Ecuador,3,5,0.09741,0.27524,9,winner,loser
Argentina,Ecuador,2,2,Copa America,Argentina,7,9,1983,0,0,4,1658,1,0,Argentina,Ecuador,3,0,0.68678,0.63706,9,draw,draw
Denmark,France,3,1,Friendly,Denmark,7,9,1983,2,-2,4,1659,1,0,Denmark,France,3,2,0.36027,0.87267,9,winner,loser
Brazil,Argentina,0,0,Copa America,Brazil,14,9,1983,0,0,0,1660,0,1,Brazil,Argentina,3,0,0.06157,0.25244,9,draw,draw
Belgium,Netherlands,1,1,Friendly,Belgium,21,9,1983,0,0,2,1661,1,1,Belgium,Netherlands,3,0,0.516,0.31535,9,draw,draw
England,Denmark,0,1,UEFA Euro qualification,England,21,9,1983,-1,1,1,1662,1,1,England,Denmark,3,1,0.0954,0.05434,9,loser,winner
France,Spain,1,1,Friendly,France,5,10,1983,0,0,2,1663,0,1,France,Spain,3,0,0.28834,0.68672,9,draw,draw
Uruguay,Brazil,2,0,Copa America,Uruguay,27,10,1983,2,-2,2,1664,1,0,Uruguay,Brazil,3,2,0.5196,0.07385,9,winner,loser
Poland,Portugal,0,1,UEFA Euro qualification,Poland,28,10,1983,-1,1,1,1665,0,1,Poland,Portugal,3,1,0.52935,0.1466,9,loser,winner
Brazil,Uruguay,1,1,Copa America,Brazil,4,11,1983,0,0,2,1666,0,1,Brazil,Uruguay,3,0,0.59588,0.41345,9,draw,draw
Switzerland,Belgium,3,1,UEFA Euro qualification,Switzerland,9,11,1983,2,-2,4,1667,0,1,Switzerland,Belgium,3,2,0.71886,0.46348,9,winner,loser
Netherlands,Spain,2,1,UEFA Euro qualification,Netherlands,16,11,1983,1,-1,3,1668,1,1,Netherlands,Spain,3,1,0.90351,0.70321,9,winner,loser
Mexico,Canada,5,0,Friendly,Mexico,6,12,1983,5,-5,5,1669,1,0,Mexico,Canada,3,5,0.96256,0.53122,9,winner,loser
Argentina,Poland,1,1,Nehru Cup,India,17,1,1984,0,0,2,1670,1,0,Argentina,Poland,4,0,0.44258,0.86481,9,draw,draw
Belgium,Germany,0,1,Friendly,Belgium,29,2,1984,-1,1,1,1671,1,1,Belgium,Germany,4,1,0.62685,0.24519,9,loser,winner
France,England,2,0,Friendly,France,29,2,1984,2,-2,2,1672,0,1,France,England,4,2,0.07741,0.9716,9,winner,loser
Saudi Arabia,Qatar,1,2,Gulf Cup,Oman,10,3,1984,-1,1,3,1673,1,0,Saudi_Arabia,Qatar,4,1,0.21232,0.73301,9,loser,winner
Netherlands,Denmark,6,0,Friendly,Netherlands,14,3,1984,6,-6,6,1674,1,1,Netherlands,Denmark,4,6,0.60019,0.19034,9,winner,loser
Switzerland,Poland,1,1,Friendly,Switzerland,27,3,1984,0,0,2,1675,0,0,Switzerland,Poland,4,0,0.61088,0.83307,9,draw,draw
Spain,Denmark,2,1,Friendly,Spain,11,4,1984,1,-1,3,1676,1,1,Spain,Denmark,4,1,0.06736,0.03883,9,winner,loser
Poland,Belgium,0,1,Friendly,Poland,17,4,1984,-1,1,1,1677,0,1,Poland,Belgium,4,1,0.1187,0.91944,9,loser,winner
France,Germany,1,0,Friendly,France,18,4,1984,1,-1,1,1678,0,1,France,Germany,4,1,0.86979,0.30231,9,winner,loser
Wales,England,1,0,British Championship,Wales,2,5,1984,1,-1,1,1679,0,1,Wales,England,4,1,0.85863,0.72236,9,winner,loser
Switzerland,Spain,0,4,Friendly,Switzerland,26,5,1984,-4,4,4,1680,0,1,Switzerland,Spain,4,4,0.25808,0.09623,9,loser,winner
Brazil,England,0,2,Friendly,Brazil,10,6,1984,-2,2,2,1681,0,1,Brazil,England,4,2,0.96518,0.60812,9,loser,winner
France,Denmark,1,0,UEFA Euro,France,12,6,1984,1,-1,1,1682,0,1,France,Denmark,4,1,0.60685,0.58891,9,winner,loser
Uruguay,England,2,0,Friendly,Uruguay,13,6,1984,2,-2,2,1683,1,1,Uruguay,England,4,2,0.29253,0.92762,9,winner,loser
Germany,Portugal,0,0,UEFA Euro,France,14,6,1984,0,0,0,1684,1,1,Germany,Portugal,4,0,0.79097,0.7286,9,draw,draw
France,Belgium,5,0,UEFA Euro,France,16,6,1984,5,-5,5,1685,0,1,France,Belgium,4,5,0.91964,0.76768,9,winner,loser
Brazil,Argentina,0,0,Friendly,Brazil,17,6,1984,0,0,0,1686,0,1,Brazil,Argentina,4,0,0.6489,0.42583,9,draw,draw
Portugal,Spain,1,1,UEFA Euro,France,17,6,1984,0,0,2,1687,1,1,Portugal,Spain,4,0,0.87493,0.40812,9,draw,draw
Denmark,Belgium,3,2,UEFA Euro,France,19,6,1984,1,-1,5,1688,1,1,Denmark,Belgium,4,1,0.33542,0.5243,9,winner,loser
Germany,Spain,0,1,UEFA Euro,France,20,6,1984,-1,1,1,1689,1,1,Germany,Spain,4,1,0.42205,0.52134,9,loser,winner
Brazil,Uruguay,1,0,Friendly,Brazil,21,6,1984,1,-1,1,1690,0,1,Brazil,Uruguay,4,1,0.49616,0.35083,9,winner,loser
France,Portugal,3,2,UEFA Euro,France,23,6,1984,1,-1,5,1691,0,1,France,Portugal,4,1,0.06142,0.58651,9,winner,loser
Morocco,Senegal,2,1,Friendly,Morocco,23,6,1984,1,-1,3,1692,0,0,Morocco,Senegal,4,1,0.65104,0.40664,9,winner,loser
Denmark,Spain,1,1,UEFA Euro,France,24,6,1984,0,0,2,1693,1,1,Denmark,Spain,4,0,0.11164,0.69124,9,draw,draw
France,Spain,2,0,UEFA Euro,France,27,6,1984,2,-2,2,1694,0,1,France,Spain,4,2,0.90999,0.31612,9,winner,loser
Uruguay,Argentina,1,0,Friendly,Uruguay,18,7,1984,1,-1,1,1695,1,1,Uruguay,Argentina,4,1,0.94989,0.86176,9,winner,loser
Argentina,Uruguay,0,0,Friendly,Argentina,2,8,1984,0,0,0,1696,1,1,Argentina,Uruguay,4,0,0.64104,0.1709,9,draw,draw
Switzerland,Argentina,0,2,Friendly,Switzerland,1,9,1984,-2,2,2,1697,0,1,Switzerland,Argentina,4,2,0.89025,0.47624,9,loser,winner
Belgium,Argentina,0,2,Friendly,Belgium,5,9,1984,-2,2,2,1698,1,1,Belgium,Argentina,4,2,0.92831,0.47525,9,loser,winner
Germany,Argentina,1,3,Friendly,Germany,12,9,1984,-2,2,4,1699,1,1,Germany,Argentina,4,2,0.62839,0.3017,9,loser,winner
Mexico,Argentina,1,1,Friendly,Mexico,18,9,1984,0,0,2,1700,1,1,Mexico,Argentina,4,0,0.27157,0.42092,9,draw,draw
South Korea,Japan,1,2,Friendly,South Korea,30,9,1984,-1,1,3,1701,0,0,South_Korea,Japan,4,1,0.6014,0.72527,9,loser,winner
South Korea,Cameroon,5,0,Friendly,South Korea,4,10,1984,5,-5,5,1702,0,1,South_Korea,Cameroon,4,5,0.29789,0.19697,9,winner,loser
Mexico,United States,2,1,Friendly,Mexico,17,10,1984,1,-1,3,1703,1,0,Mexico,United_States,4,1,0.95777,0.88735,9,winner,loser
Spain,Wales,3,0,FIFA World Cup qualification,Spain,17,10,1984,3,-3,3,1704,1,0,Spain,Wales,4,3,0.67112,0.50555,9,winner,loser
Switzerland,Denmark,1,0,FIFA World Cup qualification,Switzerland,17,10,1984,1,-1,1,1705,0,1,Switzerland,Denmark,4,1,0.28189,0.75258,9,winner,loser
Tunisia,Canada,2,0,Friendly,Tunisia,21,10,1984,2,-2,2,1706,1,0,Tunisia,Canada,4,2,0.54103,0.72895,9,winner,loser
Morocco,Canada,3,2,Friendly,Morocco,24,10,1984,1,-1,5,1707,0,0,Morocco,Canada,4,1,0.49765,0.94805,9,winner,loser
Argentina,Mexico,1,1,Friendly,Argentina,25,10,1984,0,0,2,1708,1,1,Argentina,Mexico,4,0,0.1738,0.035,9,draw,draw
Uruguay,Mexico,1,1,Friendly,Uruguay,31,10,1984,0,0,2,1709,1,1,Uruguay,Mexico,4,0,0.75516,0.16271,9,draw,draw
United States,Ecuador,0,0,Friendly,United States,30,11,1984,0,0,0,1710,0,0,United_States,Ecuador,4,0,0.3998,0.65067,9,draw,draw
Saudi Arabia,South Korea,1,1,AFC Asian Cup,Singapore,2,12,1984,0,0,2,1711,1,0,Saudi_Arabia,South_Korea,4,0,0.77512,0.03257,9,draw,draw
United States,Ecuador,2,2,Friendly,United States,2,12,1984,0,0,4,1712,0,0,United_States,Ecuador,4,0,0.57532,0.70454,9,draw,draw
Mexico,Ecuador,3,2,Friendly,United States,4,12,1984,1,-1,5,1713,1,0,Mexico,Ecuador,4,1,0.57051,0.51875,9,winner,loser
Qatar,Saudi Arabia,1,1,AFC Asian Cup,Singapore,8,12,1984,0,0,2,1714,0,1,Qatar,Saudi_Arabia,4,0,0.77797,0.96834,9,draw,draw
South Korea,Qatar,0,1,AFC Asian Cup,Singapore,10,12,1984,-1,1,1,1715,0,0,South_Korea,Qatar,4,1,0.04496,0.08842,9,loser,winner
Saudi Arabia,Iran,1,1,AFC Asian Cup,Singapore,13,12,1984,0,0,2,1716,1,1,Saudi_Arabia,Iran,4,0,0.96067,0.0764,9,draw,draw
Ghana,Tunisia,0,2,Friendly,Ivory Coast,1,1,1985,-2,2,2,1717,0,1,Ghana,Tunisia,5,2,0.60104,0.69635,9,loser,winner
Mexico,Poland,5,0,Friendly,Mexico,5,2,1985,5,-5,5,1718,1,0,Mexico,Poland,5,5,0.03439,0.89798,9,winner,loser
Mexico,Switzerland,1,2,Friendly,Mexico,6,2,1985,-1,1,3,1719,1,0,Mexico,Switzerland,5,1,0.81264,0.49626,9,loser,winner
United States,Switzerland,1,1,Friendly,United States,8,2,1985,0,0,2,1720,0,0,United_States,Switzerland,5,0,0.12173,0.98599,9,draw,draw
Portugal,Germany,1,2,FIFA World Cup qualification,Portugal,24,2,1985,-1,1,3,1721,1,1,Portugal,Germany,5,1,0.94416,0.39822,9,loser,winner
Uruguay,Ecuador,2,1,FIFA World Cup qualification,Uruguay,10,3,1985,1,-1,3,1722,1,0,Uruguay,Ecuador,5,1,0.75828,0.91725,9,winner,loser
Costa Rica,Canada,1,0,Friendly,Costa Rica,21,3,1985,1,-1,1,1723,1,0,Costa_Rica,Canada,5,1,0.09453,0.94921,9,winner,loser
Costa Rica,Canada,0,0,Friendly,Costa Rica,24,3,1985,0,0,0,1724,1,0,Costa_Rica,Canada,5,0,0.76134,0.49523,9,draw,draw
Ecuador,Uruguay,0,2,FIFA World Cup qualification,Ecuador,31,3,1985,-2,2,2,1725,0,1,Ecuador,Uruguay,5,2,0.9778,0.78402,9,loser,winner
Canada,United States,2,0,Friendly,Canada,2,4,1985,2,-2,2,1726,0,0,Canada,United_States,5,2,0.62807,0.6059,9,winner,loser
United States,Canada,1,1,Friendly,United States,4,4,1985,0,0,2,1727,0,0,United_States,Canada,5,0,0.41176,0.10326,9,draw,draw
Wales,Spain,3,0,FIFA World Cup qualification,Wales,30,4,1985,3,-3,3,1728,0,1,Wales,Spain,5,3,0.78204,0.34681,9,winner,loser
Belgium,Poland,2,0,FIFA World Cup qualification,Belgium,1,5,1985,2,-2,2,1729,1,0,Belgium,Poland,5,2,0.02164,0.02771,9,winner,loser
Brazil,Uruguay,2,0,Friendly,Brazil,2,5,1985,2,-2,2,1730,0,1,Brazil,Uruguay,5,2,0.02961,0.7639,9,winner,loser
Brazil,Argentina,2,1,Friendly,Brazil,5,5,1985,1,-1,3,1731,0,1,Brazil,Argentina,5,1,0.13001,0.90196,9,winner,loser
Costa Rica,United States,1,1,CONCACAF Championship,Costa Rica,26,5,1985,0,0,2,1732,1,0,Costa_Rica,United_States,5,0,0.2818,0.16105,9,draw,draw
Japan,Uruguay,1,4,Kirin Cup,Japan,26,5,1985,-3,3,5,1733,0,1,Japan,Uruguay,5,3,0.41592,0.69324,9,loser,winner
United States,Costa Rica,0,1,CONCACAF Championship,United States,31,5,1985,-1,1,1,1734,0,1,United_States,Costa_Rica,5,1,0.07087,0.0971,9,loser,winner
Canada,Ghana,2,1,Korea Cup,South Korea,2,6,1985,1,-1,3,1735,0,0,Canada,Ghana,5,1,0.12306,0.54403,9,winner,loser
Mexico,England,1,0,Friendly,Mexico,9,6,1985,1,-1,1,1736,1,1,Mexico,England,5,1,0.80585,0.78194,9,winner,loser
England,Germany,3,0,Friendly,Mexico,12,6,1985,3,-3,3,1737,1,1,England,Germany,5,3,0.12195,0.99602,9,winner,loser
Mexico,Germany,2,0,Friendly,Mexico,15,6,1985,2,-2,2,1738,1,1,Mexico,Germany,5,2,0.24946,0.58309,9,winner,loser
United States,England,0,5,Friendly,United States,16,6,1985,-5,5,5,1739,0,1,United_States,England,5,5,0.62844,0.0018,9,loser,winner
Saudi Arabia,Qatar,1,0,Arab Cup,Saudi Arabia,7,7,1985,1,-1,1,1740,1,0,Saudi_Arabia,Qatar,5,1,0.68041,0.55343,9,winner,loser
Saudi Arabia,Qatar,0,0,Arab Cup,Saudi Arabia,12,7,1985,0,0,0,1741,1,0,Saudi_Arabia,Qatar,5,0,0.88994,0.50866,9,draw,draw
Tunisia,Saudi Arabia,1,0,Friendly,Tunisia,28,7,1985,1,-1,1,1742,1,1,Tunisia,Saudi_Arabia,5,1,0.32368,0.72241,9,winner,loser
Canada,Costa Rica,1,1,CONCACAF Championship,Canada,17,8,1985,0,0,2,1743,0,1,Canada,Costa_Rica,5,0,0.54485,0.10767,9,draw,draw
France,Uruguay,2,0,CONMEBOL-UEFA Cup of Champions,France,21,8,1985,2,-2,2,1744,0,1,France,Uruguay,5,2,0.88881,0.70928,9,winner,loser
Costa Rica,Canada,0,0,CONCACAF Championship,Costa Rica,1,9,1985,0,0,0,1745,1,0,Costa_Rica,Canada,5,0,0.75541,0.12855,9,draw,draw
Poland,Belgium,0,0,FIFA World Cup qualification,Poland,11,9,1985,0,0,0,1746,0,1,Poland,Belgium,5,0,0.66167,0.1323,9,draw,draw
Cameroon,Saudi Arabia,4,1,Friendly,Cameroon,15,9,1985,3,-3,5,1747,1,1,Cameroon,Saudi_Arabia,5,3,0.97306,0.78936,9,winner,loser
Saudi Arabia,Cameroon,2,1,Friendly,Saudi Arabia,4,10,1985,1,-1,3,1748,1,1,Saudi_Arabia,Cameroon,5,1,0.36577,0.68907,9,winner,loser
Denmark,Switzerland,0,0,FIFA World Cup qualification,Denmark,9,10,1985,0,0,0,1749,1,0,Denmark,Switzerland,5,0,0.48648,0.48802,9,draw,draw
Belgium,Netherlands,1,0,FIFA World Cup qualification,Belgium,16,10,1985,1,-1,1,1750,1,1,Belgium,Netherlands,5,1,0.19211,0.61314,9,winner,loser
Germany,Portugal,0,1,FIFA World Cup qualification,Germany,16,10,1985,-1,1,1,1751,1,1,Germany,Portugal,5,1,0.59907,0.8509,9,loser,winner
Japan,South Korea,1,2,FIFA World Cup qualification,Japan,26,10,1985,-1,1,3,1752,0,0,Japan,South_Korea,5,1,0.98647,0.41271,9,loser,winner
South Korea,Japan,1,0,FIFA World Cup qualification,South Korea,3,11,1985,1,-1,1,1753,0,0,South_Korea,Japan,5,1,0.91871,0.18694,9,winner,loser
Mexico,Argentina,1,1,Friendly,United States,14,11,1985,0,0,2,1754,1,1,Mexico,Argentina,5,0,0.75785,0.3148,9,draw,draw
Mexico,Argentina,1,1,Friendly,Mexico,17,11,1985,0,0,2,1755,1,1,Mexico,Argentina,5,0,0.33116,0.92421,9,draw,draw
Netherlands,Belgium,2,1,FIFA World Cup qualification,Netherlands,20,11,1985,1,-1,3,1756,1,1,Netherlands,Belgium,5,1,0.40833,0.0121,9,winner,loser
Mexico,South Korea,2,1,Friendly,United States,3,12,1985,1,-1,3,1757,1,0,Mexico,South_Korea,5,1,0.20381,0.02011,9,winner,loser
Tunisia,Poland,1,0,Friendly,Tunisia,8,12,1985,1,-1,1,1758,1,0,Tunisia,Poland,5,1,0.28185,0.63273,9,winner,loser
Mexico,South Korea,2,1,Friendly,Mexico,10,12,1985,1,-1,3,1759,1,0,Mexico,South_Korea,5,1,0.35515,0.3244,9,winner,loser
Qatar,Tunisia,2,1,Friendly,Qatar,24,1,1986,1,-1,3,1760,0,1,Qatar,Tunisia,6,1,0.00694,0.76324,9,winner,loser
Canada,Uruguay,1,3,Friendly,United States,2,2,1986,-2,2,4,1761,0,1,Canada,Uruguay,6,2,0.52528,0.98434,9,loser,winner
United States,Canada,0,0,Friendly,United States,5,2,1986,0,0,0,1762,0,0,United_States,Canada,6,0,0.45129,0.40602,9,draw,draw
United States,Uruguay,1,1,Friendly,United States,7,2,1986,0,0,2,1763,0,1,United_States,Uruguay,6,0,0.21576,0.05853,9,draw,draw
Uruguay,Poland,2,2,Friendly,Uruguay,16,2,1986,0,0,4,1764,1,0,Uruguay,Poland,6,0,0.94548,0.2432,9,draw,draw
Spain,Belgium,3,0,Friendly,Spain,19,2,1986,3,-3,3,1765,1,1,Spain,Belgium,6,3,0.86712,0.35991,9,winner,loser
Iran,Ghana,2,0,Friendly,Iran,20,2,1986,2,-2,2,1766,1,0,Iran,Ghana,6,2,0.57612,0.48703,9,winner,loser
Saudi Arabia,Wales,1,2,Friendly,Saudi Arabia,25,2,1986,-1,1,3,1767,1,0,Saudi_Arabia,Wales,6,1,0.39901,0.65176,9,loser,winner
Tunisia,Cameroon,1,1,Friendly,Tunisia,26,2,1986,0,0,2,1768,1,1,Tunisia,Cameroon,6,0,0.60505,0.97638,9,draw,draw
Mexico,Denmark,1,1,Friendly,United States,6,3,1986,0,0,2,1769,1,1,Mexico,Denmark,6,0,0.057,0.8965,9,draw,draw
Cameroon,Morocco,1,1,African Cup of Nations,Egypt,11,3,1986,0,0,2,1770,1,0,Cameroon,Morocco,6,0,0.17082,0.66054,9,draw,draw
Germany,Brazil,2,0,Friendly,Germany,12,3,1986,2,-2,2,1771,1,0,Germany,Brazil,6,2,0.62803,0.5441,9,winner,loser
France,Argentina,2,0,Friendly,France,26,3,1986,2,-2,2,1772,0,1,France,Argentina,6,2,0.68141,0.82232,9,winner,loser
Spain,Poland,3,0,Friendly,Spain,26,3,1986,3,-3,3,1773,1,0,Spain,Poland,6,3,0.54079,0.73313,9,winner,loser
Qatar,Saudi Arabia,0,2,Gulf Cup,Bahrain,5,4,1986,-2,2,2,1774,0,1,Qatar,Saudi_Arabia,6,2,0.62979,0.83628,9,loser,winner
Switzerland,Germany,0,1,Friendly,Switzerland,9,4,1986,-1,1,1,1775,0,1,Switzerland,Germany,6,1,0.12511,0.19504,9,loser,winner
Mexico,Uruguay,1,0,Friendly,United States,13,4,1986,1,-1,1,1776,1,1,Mexico,Uruguay,6,1,0.2589,0.38968,9,winner,loser
Wales,Uruguay,0,0,Friendly,Wales,21,4,1986,0,0,0,1777,0,1,Wales,Uruguay,6,0,0.39247,0.41351,9,draw,draw
Mexico,Canada,3,0,Friendly,Mexico,27,4,1986,3,-3,3,1778,1,0,Mexico,Canada,6,3,0.82612,0.09088,9,winner,loser
Canada,Wales,2,0,Friendly,Canada,10,5,1986,2,-2,2,1779,0,0,Canada,Wales,6,2,0.0742,0.73186,9,winner,loser
Germany,Netherlands,3,1,Friendly,Germany,14,5,1986,2,-2,4,1780,1,1,Germany,Netherlands,6,2,0.44302,0.48214,9,winner,loser
Denmark,Poland,1,0,Friendly,Denmark,16,5,1986,1,-1,1,1781,1,0,Denmark,Poland,6,1,0.35473,0.63112,9,winner,loser
Mexico,England,0,3,Friendly,United States,17,5,1986,-3,3,3,1782,1,1,Mexico,England,6,3,0.33685,0.68754,9,loser,winner
Canada,Wales,0,3,Friendly,Canada,19,5,1986,-3,3,3,1783,0,0,Canada,Wales,6,3,0.25546,0.01747,9,loser,winner
Canada,England,0,1,Friendly,Canada,24,5,1986,-1,1,1,1784,0,1,Canada,England,6,1,0.76194,0.19841,9,loser,winner
Canada,France,0,1,FIFA World Cup,Mexico,1,6,1986,-1,1,1,1785,0,0,Canada,France,6,1,0.55967,0.25978,9,loser,winner
Spain,Brazil,0,1,FIFA World Cup,Mexico,1,6,1986,-1,1,1,1786,1,0,Spain,Brazil,6,1,0.59656,0.1174,9,loser,winner
Argentina,South Korea,3,1,FIFA World Cup,Mexico,2,6,1986,2,-2,4,1787,1,0,Argentina,South_Korea,6,2,0.09312,0.9841,9,winner,loser
Morocco,Poland,0,0,FIFA World Cup,Mexico,2,6,1986,0,0,0,1788,0,0,Morocco,Poland,6,0,0.66289,0.03544,9,draw,draw
Mexico,Belgium,2,1,FIFA World Cup,Mexico,3,6,1986,1,-1,3,1789,1,1,Mexico,Belgium,6,1,0.04758,0.11771,9,winner,loser
Portugal,England,1,0,FIFA World Cup,Mexico,3,6,1986,1,-1,1,1790,1,1,Portugal,England,6,1,0.70049,0.45575,9,winner,loser
Uruguay,Germany,1,1,FIFA World Cup,Mexico,4,6,1986,0,0,2,1791,1,1,Uruguay,Germany,6,0,0.90179,0.87448,9,draw,draw
England,Morocco,0,0,FIFA World Cup,Mexico,6,6,1986,0,0,0,1792,1,0,England,Morocco,6,0,0.77135,0.19563,9,draw,draw
Poland,Portugal,1,0,FIFA World Cup,Mexico,7,6,1986,1,-1,1,1793,0,1,Poland,Portugal,6,1,0.40745,0.53913,9,winner,loser
Denmark,Uruguay,6,1,FIFA World Cup,Mexico,8,6,1986,5,-5,7,1794,1,1,Denmark,Uruguay,6,5,0.19461,0.53935,9,winner,loser
England,Poland,3,0,FIFA World Cup,Mexico,11,6,1986,3,-3,3,1795,1,0,England,Poland,6,3,0.78831,0.39314,9,winner,loser
Portugal,Morocco,1,3,FIFA World Cup,Mexico,11,6,1986,-2,2,4,1796,1,0,Portugal,Morocco,6,2,0.93917,0.21401,9,loser,winner
Denmark,Germany,2,0,FIFA World Cup,Mexico,13,6,1986,2,-2,2,1797,1,1,Denmark,Germany,6,2,0.36514,0.77975,9,winner,loser
Argentina,Uruguay,1,0,FIFA World Cup,Mexico,16,6,1986,1,-1,1,1798,1,1,Argentina,Uruguay,6,1,0.05385,0.7195,9,winner,loser
Brazil,Poland,4,0,FIFA World Cup,Mexico,16,6,1986,4,-4,4,1799,0,0,Brazil,Poland,6,4,0.46391,0.4565,9,winner,loser
Morocco,Germany,0,1,FIFA World Cup,Mexico,17,6,1986,-1,1,1,1800,0,1,Morocco,Germany,6,1,0.01279,0.88616,9,loser,winner
Denmark,Spain,1,5,FIFA World Cup,Mexico,18,6,1986,-4,4,6,1801,1,1,Denmark,Spain,6,4,0.85582,0.73168,9,loser,winner
Brazil,France,1,1,FIFA World Cup,Mexico,21,6,1986,0,0,2,1802,0,0,Brazil,France,6,0,0.68057,0.07639,9,draw,draw
Mexico,Germany,0,0,FIFA World Cup,Mexico,21,6,1986,0,0,0,1803,1,1,Mexico,Germany,6,0,0.16643,0.03991,9,draw,draw
Argentina,England,2,1,FIFA World Cup,Mexico,22,6,1986,1,-1,3,1804,1,1,Argentina,England,6,1,0.24582,0.66961,9,winner,loser
Spain,Belgium,1,1,FIFA World Cup,Mexico,22,6,1986,0,0,2,1805,1,1,Spain,Belgium,6,0,0.91321,0.84721,9,draw,draw
Argentina,Belgium,2,0,FIFA World Cup,Mexico,25,6,1986,2,-2,2,1806,1,1,Argentina,Belgium,6,2,0.70072,0.47983,9,winner,loser
France,Germany,0,2,FIFA World Cup,Mexico,25,6,1986,-2,2,2,1807,0,1,France,Germany,6,2,0.29757,0.16248,9,loser,winner
France,Belgium,4,2,FIFA World Cup,Mexico,28,6,1986,2,-2,6,1808,0,1,France,Belgium,6,2,0.79018,0.35638,9,winner,loser
Argentina,Germany,3,2,FIFA World Cup,Mexico,29,6,1986,1,-1,5,1809,1,1,Argentina,Germany,6,1,0.40764,0.04224,9,winner,loser
Switzerland,France,2,0,Friendly,Switzerland,19,8,1986,2,-2,2,1810,0,0,Switzerland,France,6,2,0.96598,0.21475,9,winner,loser
Denmark,Germany,0,2,Friendly,Denmark,24,9,1986,-2,2,2,1811,1,1,Denmark,Germany,6,2,0.39027,0.45224,9,loser,winner
Germany,Spain,2,2,Friendly,Germany,15,10,1986,0,0,4,1812,1,1,Germany,Spain,6,0,0.05933,0.08106,9,draw,draw
Switzerland,Portugal,1,1,UEFA Euro qualification,Switzerland,29,10,1986,0,0,2,1813,0,1,Switzerland,Portugal,6,0,0.67357,0.37232,9,draw,draw
Netherlands,Poland,0,0,UEFA Euro qualification,Netherlands,19,11,1986,0,0,0,1814,1,0,Netherlands,Poland,6,0,0.3729,0.89786,9,draw,draw
Spain,Netherlands,1,1,Friendly,Spain,21,1,1987,0,0,2,1815,1,1,Spain,Netherlands,7,0,0.73184,0.39812,9,draw,draw
Portugal,Belgium,1,0,Friendly,Portugal,4,2,1987,1,-1,1,1816,1,1,Portugal,Belgium,7,1,0.1637,0.39714,9,winner,loser
Spain,England,2,4,Friendly,Spain,18,2,1987,-2,2,6,1817,1,1,Spain,England,7,2,0.8487,0.17812,9,loser,winner
England,Brazil,1,1,Rous Cup,England,19,5,1987,0,0,2,1818,1,0,England,Brazil,7,0,0.74207,0.01359,9,draw,draw
Japan,Senegal,2,2,Kirin Cup,Japan,27,5,1987,0,0,4,1819,0,0,Japan,Senegal,7,0,0.07305,0.50996,9,draw,draw
Australia,Morocco,1,0,Korea Cup,South Korea,9,6,1987,1,-1,1,1820,0,0,Australia,Morocco,7,1,0.33381,0.71314,9,winner,loser
South Korea,United States,1,0,Korea Cup,South Korea,12,6,1987,1,-1,1,1821,0,0,South_Korea,United_States,7,1,0.43292,0.35206,9,winner,loser
Uruguay,Ecuador,2,1,Friendly,Uruguay,19,6,1987,1,-1,3,1822,1,0,Uruguay,Ecuador,7,1,0.13295,0.88267,9,winner,loser
Brazil,Ecuador,4,1,Friendly,Brazil,21,6,1987,3,-3,5,1823,0,0,Brazil,Ecuador,7,3,0.851,0.17335,9,winner,loser
South Korea,Australia,1,1,Korea Cup,South Korea,21,6,1987,0,0,2,1824,0,0,South_Korea,Australia,7,0,0.13706,0.27642,9,draw,draw
Argentina,Ecuador,3,0,Copa America,Argentina,2,7,1987,3,-3,3,1825,1,0,Argentina,Ecuador,7,3,0.523,0.11132,9,winner,loser
Argentina,Uruguay,0,1,Copa America,Argentina,9,7,1987,-1,1,1,1826,1,1,Argentina,Uruguay,7,1,0.15202,0.76807,9,loser,winner
Germany,France,2,1,Friendly,Germany,12,8,1987,1,-1,3,1827,1,0,Germany,France,7,1,0.01074,0.90193,9,winner,loser
Germany,England,3,1,Friendly,Germany,9,9,1987,2,-2,4,1828,1,1,Germany,England,7,2,0.36625,0.01438,9,winner,loser
Netherlands,Belgium,0,0,Friendly,Netherlands,9,9,1987,0,0,0,1829,1,1,Netherlands,Belgium,7,0,0.93714,0.77345,9,draw,draw
Wales,Denmark,1,0,UEFA Euro qualification,Wales,9,9,1987,1,-1,1,1830,0,1,Wales,Denmark,7,1,0.97389,0.50968,9,winner,loser
Germany,Denmark,1,0,Friendly,Germany,23,9,1987,1,-1,1,1831,1,1,Germany,Denmark,7,1,0.59843,0.73742,9,winner,loser
Mexico,Canada,4,0,Friendly,Mexico,6,10,1987,4,-4,4,1832,1,0,Mexico,Canada,7,4,0.28777,0.70462,9,winner,loser
Denmark,Wales,1,0,UEFA Euro qualification,Denmark,14,10,1987,1,-1,1,1833,1,0,Denmark,Wales,7,1,0.11257,0.57816,9,winner,loser
Poland,Netherlands,0,2,UEFA Euro qualification,Poland,14,10,1987,-2,2,2,1834,0,1,Poland,Netherlands,7,2,0.28168,0.76583,9,loser,winner
Portugal,Switzerland,0,0,UEFA Euro qualification,Portugal,11,11,1987,0,0,0,1835,1,0,Portugal,Switzerland,7,0,0.84432,0.9559,9,draw,draw
Brazil,Germany,1,1,Friendly,Brazil,12,12,1987,0,0,2,1836,0,1,Brazil,Germany,7,0,0.49642,0.90163,9,draw,draw
Argentina,Germany,1,0,Friendly,Argentina,16,12,1987,1,-1,1,1837,1,1,Argentina,Germany,7,1,0.74973,0.43515,9,winner,loser
France,Switzerland,2,1,Tournoi de France,France,2,2,1988,1,-1,3,1838,0,0,France,Switzerland,8,1,0.33168,0.3035,9,winner,loser
France,Morocco,2,1,Tournoi de France,Monaco,5,2,1988,1,-1,3,1839,0,0,France,Morocco,8,1,0.15234,0.48179,9,winner,loser
Saudi Arabia,Qatar,0,0,Gulf Cup,Saudi Arabia,5,3,1988,0,0,0,1840,1,0,Saudi_Arabia,Qatar,8,0,0.07859,0.99615,9,draw,draw
England,Netherlands,2,2,Friendly,England,23,3,1988,0,0,4,1841,1,1,England,Netherlands,8,0,0.27875,0.6266,9,draw,draw
France,Spain,2,1,Friendly,France,23,3,1988,1,-1,3,1842,0,1,France,Spain,8,1,0.87661,0.33281,9,winner,loser
Morocco,Cameroon,0,1,African Cup of Nations,Morocco,23,3,1988,-1,1,1,1843,0,1,Morocco,Cameroon,8,1,0.85278,0.32649,9,loser,winner
Germany,Argentina,1,0,Friendly,Germany,2,4,1988,1,-1,1,1844,1,1,Germany,Argentina,8,1,0.1642,0.21524,9,winner,loser
Germany,Switzerland,1,0,Friendly,Germany,27,4,1988,1,-1,1,1845,1,0,Germany,Switzerland,8,1,0.4797,0.76389,9,winner,loser
Switzerland,England,0,1,Friendly,Switzerland,28,5,1988,-1,1,1,1846,0,1,Switzerland,England,8,1,0.17571,0.92148,9,loser,winner
Denmark,Belgium,3,1,Friendly,Denmark,5,6,1988,2,-2,4,1847,1,1,Denmark,Belgium,8,2,0.96651,0.70457,9,winner,loser
Switzerland,Spain,1,1,Friendly,Switzerland,5,6,1988,0,0,2,1848,0,1,Switzerland,Spain,8,0,0.87146,0.7622,9,draw,draw
United States,Ecuador,0,1,Friendly,United States,7,6,1988,-1,1,1,1849,0,0,United_States,Ecuador,8,1,0.72281,0.61767,9,loser,winner
United States,Ecuador,0,2,Friendly,United States,10,6,1988,-2,2,2,1850,0,0,United_States,Ecuador,8,2,0.33589,0.88299,9,loser,winner
Denmark,Spain,2,3,UEFA Euro,Germany,11,6,1988,-1,1,5,1851,1,1,Denmark,Spain,8,1,0.8863,0.08384,9,loser,winner
United States,Ecuador,0,0,Friendly,United States,12,6,1988,0,0,0,1852,0,0,United_States,Ecuador,8,0,0.12117,0.7364,9,draw,draw
Germany,Denmark,2,0,UEFA Euro,Germany,14,6,1988,2,-2,2,1853,1,1,Germany,Denmark,8,2,0.69838,0.74979,9,winner,loser
United States,Costa Rica,1,0,Friendly,United States,14,6,1988,1,-1,1,1854,0,1,United_States,Costa_Rica,8,1,0.37858,0.67575,9,winner,loser
England,Netherlands,1,3,UEFA Euro,Germany,15,6,1988,-2,2,4,1855,1,1,England,Netherlands,8,2,0.38666,0.28827,9,loser,winner
Canada,Costa Rica,0,1,Friendly,Canada,17,6,1988,-1,1,1,1856,0,1,Canada,Costa_Rica,8,1,0.57832,0.36522,9,loser,winner
Germany,Spain,2,0,UEFA Euro,Germany,17,6,1988,2,-2,2,1857,1,1,Germany,Spain,8,2,0.07792,0.32882,9,winner,loser
Germany,Netherlands,1,2,UEFA Euro,Germany,21,6,1988,-1,1,3,1858,1,1,Germany,Netherlands,8,1,0.50865,0.83471,9,loser,winner
Argentina,Saudi Arabia,2,2,Friendly,Australia,6,7,1988,0,0,4,1859,1,1,Argentina,Saudi_Arabia,8,0,0.57742,0.25929,9,draw,draw
Australia,Brazil,0,1,Friendly,Australia,7,7,1988,-1,1,1,1860,0,0,Australia,Brazil,8,1,0.97429,0.60666,9,loser,winner
Australia,Saudi Arabia,3,0,Friendly,Australia,9,7,1988,3,-3,3,1861,0,1,Australia,Saudi_Arabia,8,3,0.16072,0.33349,9,winner,loser
Argentina,Brazil,0,0,Friendly,Australia,10,7,1988,0,0,0,1862,1,0,Argentina,Brazil,8,0,0.96526,0.59702,9,draw,draw
Brazil,Saudi Arabia,4,1,Friendly,Australia,13,7,1988,3,-3,5,1863,0,1,Brazil,Saudi_Arabia,8,3,0.69535,0.67272,9,winner,loser
Australia,Argentina,4,1,Friendly,Australia,14,7,1988,3,-3,5,1864,0,1,Australia,Argentina,8,3,0.66148,0.6812,9,winner,loser
Canada,Poland,1,2,Friendly,Canada,15,7,1988,-1,1,3,1865,0,0,Canada,Poland,8,1,0.59576,0.30924,9,loser,winner
Argentina,Saudi Arabia,2,0,Friendly,Australia,16,7,1988,2,-2,2,1866,1,1,Argentina,Saudi_Arabia,8,2,0.50719,0.80685,9,winner,loser
Australia,Brazil,0,2,Friendly,Australia,17,7,1988,-2,2,2,1867,0,0,Australia,Brazil,8,2,0.27247,0.04018,9,loser,winner
England,Denmark,1,0,Friendly,England,14,9,1988,1,-1,1,1868,1,1,England,Denmark,8,1,0.91334,0.74327,9,winner,loser
Netherlands,Wales,1,0,FIFA World Cup qualification,Netherlands,14,9,1988,1,-1,1,1869,1,0,Netherlands,Wales,8,1,0.99706,0.85355,9,winner,loser
Saudi Arabia,Iran,1,0,AFC Asian Cup,Qatar,15,9,1988,1,-1,1,1870,1,1,Saudi_Arabia,Iran,8,1,0.16373,0.89823,9,winner,loser
Ecuador,Uruguay,1,2,Friendly,Paraguay,27,9,1988,-1,1,3,1871,0,1,Ecuador,Uruguay,8,1,0.71359,0.786,9,loser,winner
Belgium,Brazil,1,2,Friendly,Belgium,12,10,1988,-1,1,3,1872,1,0,Belgium,Brazil,8,1,0.63799,0.46042,9,loser,winner
Spain,Argentina,1,1,Friendly,Spain,12,10,1988,0,0,2,1873,1,1,Spain,Argentina,8,0,0.4129,0.85142,9,draw,draw
Belgium,Switzerland,1,0,FIFA World Cup qualification,Belgium,19,10,1988,1,-1,1,1874,1,0,Belgium,Switzerland,8,1,0.85572,0.51102,9,winner,loser
Germany,Netherlands,0,0,FIFA World Cup qualification,Germany,19,10,1988,0,0,0,1875,1,1,Germany,Netherlands,8,0,0.67062,0.10272,9,draw,draw
Japan,South Korea,0,1,Friendly,Japan,26,10,1988,-1,1,1,1876,0,0,Japan,South_Korea,8,1,0.04219,0.71041,9,loser,winner
Saudi Arabia,England,1,1,Friendly,Saudi Arabia,16,11,1988,0,0,2,1877,1,1,Saudi_Arabia,England,8,0,0.93935,0.81118,9,draw,draw
Saudi Arabia,Tunisia,1,0,Friendly,Saudi Arabia,29,11,1988,1,-1,1,1878,1,1,Saudi_Arabia,Tunisia,8,1,0.31317,0.81811,9,winner,loser
Qatar,Iran,0,2,AFC Asian Cup,Qatar,2,12,1988,-2,2,2,1879,0,1,Qatar,Iran,8,2,0.09604,0.08646,9,loser,winner
Japan,Iran,0,0,AFC Asian Cup,Qatar,4,12,1988,0,0,0,1880,0,1,Japan,Iran,8,0,0.08453,0.58192,9,draw,draw
South Korea,Japan,2,0,AFC Asian Cup,Qatar,6,12,1988,2,-2,2,1881,0,0,South_Korea,Japan,8,2,0.12086,0.19855,9,winner,loser
Qatar,South Korea,2,3,AFC Asian Cup,Qatar,9,12,1988,-1,1,5,1882,0,0,Qatar,South_Korea,8,1,0.21404,0.54202,9,loser,winner
South Korea,Iran,3,0,AFC Asian Cup,Qatar,11,12,1988,3,-3,3,1883,0,1,South_Korea,Iran,8,3,0.04381,0.27405,9,winner,loser
Qatar,Japan,3,0,AFC Asian Cup,Qatar,12,12,1988,3,-3,3,1884,0,0,Qatar,Japan,8,3,0.36598,0.15785,9,winner,loser
South Korea,Saudi Arabia,0,0,AFC Asian Cup,Qatar,18,12,1988,0,0,0,1885,0,1,South_Korea,Saudi_Arabia,8,0,0.5179,0.28198,9,draw,draw
Iran,Japan,2,2,Friendly,Iran,20,1,1989,0,0,4,1886,1,0,Iran,Japan,9,0,0.97742,0.81624,9,draw,draw
Tunisia,Morocco,2,1,FIFA World Cup qualification,Tunisia,22,1,1989,1,-1,3,1887,1,0,Tunisia,Morocco,9,1,0.05778,0.12122,9,winner,loser
Mexico,Poland,3,1,Friendly,Mexico,14,2,1989,2,-2,4,1888,1,0,Mexico,Poland,9,2,0.63265,0.51093,9,winner,loser
Portugal,Belgium,1,1,FIFA World Cup qualification,Portugal,15,2,1989,0,0,2,1889,1,1,Portugal,Belgium,9,0,0.31412,0.77699,9,draw,draw
Brazil,Ecuador,1,0,Friendly,Brazil,15,3,1989,1,-1,1,1890,0,0,Brazil,Ecuador,9,1,0.17911,0.65649,9,winner,loser
Denmark,Canada,2,0,Friendly,Denmark,12,4,1989,2,-2,2,1891,1,0,Denmark,Canada,9,2,0.33296,0.70485,9,winner,loser
Ecuador,Argentina,2,2,Friendly,Ecuador,13,4,1989,0,0,4,1892,0,1,Ecuador,Argentina,9,0,0.51813,0.2939,9,draw,draw
Costa Rica,United States,1,0,CONCACAF Championship,Costa Rica,16,4,1989,1,-1,1,1893,1,0,Costa_Rica,United_States,9,1,0.05787,0.30945,9,winner,loser
Netherlands,Germany,1,1,FIFA World Cup qualification,Netherlands,26,4,1989,0,0,2,1894,1,1,Netherlands,Germany,9,0,0.76808,0.42861,9,draw,draw
Portugal,Switzerland,3,1,FIFA World Cup qualification,Portugal,26,4,1989,2,-2,4,1895,1,0,Portugal,Switzerland,9,2,0.28893,0.70608,9,winner,loser
United States,Costa Rica,1,0,CONCACAF Championship,United States,30,4,1989,1,-1,1,1896,0,1,United_States,Costa_Rica,9,1,0.22491,0.01396,9,winner,loser
Uruguay,Ecuador,3,1,Friendly,Uruguay,3,5,1989,2,-2,4,1897,1,0,Uruguay,Ecuador,9,2,0.00172,0.51762,9,winner,loser
South Korea,Japan,1,0,Friendly,South Korea,5,5,1989,1,-1,1,1898,0,0,South_Korea,Japan,9,1,0.06261,0.18008,9,winner,loser
Ecuador,Uruguay,1,1,Friendly,Ecuador,23,5,1989,0,0,2,1899,0,1,Ecuador,Uruguay,9,0,0.11253,0.62602,9,draw,draw
Wales,Germany,0,0,FIFA World Cup qualification,Wales,31,5,1989,0,0,0,1900,0,1,Wales,Germany,9,0,0.39076,0.69871,9,draw,draw
England,Poland,3,0,FIFA World Cup qualification,England,3,6,1989,3,-3,3,1901,1,0,England,Poland,9,3,0.13398,0.85684,9,winner,loser
Denmark,England,1,1,Friendly,Denmark,7,6,1989,0,0,2,1902,1,1,Denmark,England,9,0,0.81474,0.13929,9,draw,draw
Brazil,Portugal,4,0,Friendly,Brazil,8,6,1989,4,-4,4,1903,0,1,Brazil,Portugal,9,4,0.80032,0.69101,9,winner,loser
Canada,Belgium,0,2,Friendly,Canada,8,6,1989,-2,2,2,1904,0,1,Canada,Belgium,9,2,0.71854,0.74604,9,loser,winner
Denmark,Brazil,4,0,Friendly,Denmark,18,6,1989,4,-4,4,1905,1,0,Denmark,Brazil,9,4,0.30516,0.29638,9,winner,loser
Switzerland,Brazil,1,0,Friendly,Switzerland,21,6,1989,1,-1,1,1906,0,0,Switzerland,Brazil,9,1,0.26204,0.62314,9,winner,loser
Uruguay,Ecuador,0,1,Copa America,Brazil,2,7,1989,-1,1,1,1907,1,0,Uruguay,Ecuador,9,1,0.89994,0.37652,9,loser,winner
Argentina,Ecuador,0,0,Copa America,Brazil,4,7,1989,0,0,0,1908,1,0,Argentina,Ecuador,9,0,0.40961,0.80267,9,draw,draw
Uruguay,Argentina,0,1,Copa America,Brazil,8,7,1989,-1,1,1,1909,1,1,Uruguay,Argentina,9,1,0.02289,0.19533,9,loser,winner
Brazil,Argentina,2,0,Copa America,Brazil,12,7,1989,2,-2,2,1910,0,1,Brazil,Argentina,9,2,0.01253,0.9834,9,winner,loser
Argentina,Uruguay,0,2,Copa America,Brazil,14,7,1989,-2,2,2,1911,1,1,Argentina,Uruguay,9,2,0.95937,0.24073,9,loser,winner
Brazil,Uruguay,1,0,Copa America,Brazil,16,7,1989,1,-1,1,1912,0,1,Brazil,Uruguay,9,1,0.38632,0.56372,9,winner,loser
Senegal,Tunisia,3,0,African Cup of Nations qualification,Senegal,16,7,1989,3,-3,3,1913,0,1,Senegal,Tunisia,9,3,0.18186,0.28968,9,winner,loser
Brazil,Japan,1,0,Friendly,Brazil,23,7,1989,1,-1,1,1914,0,0,Brazil,Japan,9,1,0.41874,0.83375,9,winner,loser
Tunisia,Senegal,0,1,African Cup of Nations qualification,Tunisia,30,7,1989,-1,1,1,1915,1,0,Tunisia,Senegal,9,1,0.21737,0.99432,9,loser,winner
Mexico,South Korea,4,2,Friendly,United States,10,8,1989,2,-2,6,1916,1,0,Mexico,South_Korea,9,2,0.93708,0.19612,9,winner,loser
Morocco,Tunisia,0,0,FIFA World Cup qualification,Morocco,13,8,1989,0,0,0,1917,0,1,Morocco,Tunisia,9,0,0.88209,0.81568,9,draw,draw
United States,South Korea,1,2,Friendly,United States,13,8,1989,-1,1,3,1918,0,0,United_States,South_Korea,9,1,0.31935,0.72943,9,loser,winner
Belgium,Denmark,3,0,Friendly,Belgium,23,8,1989,3,-3,3,1919,1,1,Belgium,Denmark,9,3,0.40656,0.89568,9,winner,loser
Belgium,Portugal,3,0,FIFA World Cup qualification,Belgium,6,9,1989,3,-3,3,1920,1,1,Belgium,Portugal,9,3,0.66706,0.88869,9,winner,loser
Netherlands,Denmark,2,2,Friendly,Netherlands,6,9,1989,0,0,4,1921,1,1,Netherlands,Denmark,9,0,0.45467,0.45285,9,draw,draw
Spain,Poland,1,0,Friendly,Spain,20,9,1989,1,-1,1,1922,1,0,Spain,Poland,9,1,0.22833,0.16668,9,winner,loser
Switzerland,Portugal,1,2,FIFA World Cup qualification,Switzerland,20,9,1989,-1,1,3,1923,0,1,Switzerland,Portugal,9,1,0.08804,0.25347,9,loser,winner
Cameroon,Tunisia,2,0,FIFA World Cup qualification,Cameroon,8,10,1989,2,-2,2,1924,1,1,Cameroon,Tunisia,9,2,0.64492,0.3541,9,winner,loser
Poland,England,0,0,FIFA World Cup qualification,Poland,11,10,1989,0,0,0,1925,0,1,Poland,England,9,0,0.4952,0.38507,9,draw,draw
Switzerland,Belgium,2,2,FIFA World Cup qualification,Switzerland,11,10,1989,0,0,4,1926,0,1,Switzerland,Belgium,9,0,0.27032,0.43889,9,draw,draw
Wales,Netherlands,1,2,FIFA World Cup qualification,Wales,11,10,1989,-1,1,3,1927,0,1,Wales,Netherlands,9,1,0.53922,0.37407,9,loser,winner
South Korea,Qatar,0,0,FIFA World Cup qualification,Singapore,13,10,1989,0,0,0,1928,0,0,South_Korea,Qatar,9,0,0.01533,0.89233,9,draw,draw
Qatar,Saudi Arabia,1,1,FIFA World Cup qualification,Singapore,16,10,1989,0,0,2,1929,0,1,Qatar,Saudi_Arabia,9,0,0.21309,0.3831,9,draw,draw
Saudi Arabia,South Korea,0,2,FIFA World Cup qualification,Singapore,25,10,1989,-2,2,2,1930,1,0,Saudi_Arabia,South_Korea,9,2,0.37816,0.57979,9,loser,winner
Germany,Wales,2,1,FIFA World Cup qualification,Germany,15,11,1989,1,-1,3,1931,1,0,Germany,Wales,9,1,0.2538,0.56933,9,winner,loser
Tunisia,Cameroon,0,1,FIFA World Cup qualification,Tunisia,19,11,1989,-1,1,1,1932,1,1,Tunisia,Cameroon,9,1,0.10503,0.00656,9,loser,winner
Spain,Switzerland,2,1,Friendly,Spain,13,12,1989,1,-1,3,1933,1,0,Spain,Switzerland,9,1,0.40678,0.6542,9,winner,loser
Netherlands,Brazil,0,1,Friendly,Netherlands,20,12,1989,-1,1,1,1934,1,0,Netherlands,Brazil,9,1,0.9946,0.47766,9,loser,winner
Mexico,Argentina,2,0,Friendly,United States,17,1,1990,2,-2,2,1935,1,1,Mexico,Argentina,0,2,0.31855,0.03225,10,winner,loser
Iran,Poland,0,2,Friendly,Iran,2,2,1990,-2,2,2,1936,1,0,Iran,Poland,0,2,0.94621,0.00278,10,loser,winner
United States,Costa Rica,0,2,Friendly,United States,2,2,1990,-2,2,2,1937,0,1,United_States,Costa_Rica,0,2,0.42449,0.30545,10,loser,winner
Costa Rica,Uruguay,0,2,Friendly,United States,4,2,1990,-2,2,2,1938,1,1,Costa_Rica,Uruguay,0,2,0.26455,0.98679,10,loser,winner
Iran,Poland,0,1,Friendly,Iran,4,2,1990,-1,1,1,1939,1,0,Iran,Poland,0,1,0.76873,0.62456,10,loser,winner
France,Germany,2,1,Friendly,France,28,2,1990,1,-1,3,1940,0,1,France,Germany,0,1,0.63317,0.61445,10,winner,loser
Cameroon,Senegal,0,2,African Cup of Nations,Algeria,6,3,1990,-2,2,2,1941,1,0,Cameroon,Senegal,0,2,0.38121,0.33369,10,loser,winner
Mexico,Uruguay,2,1,Friendly,United States,20,3,1990,1,-1,3,1942,1,1,Mexico,Uruguay,0,1,0.73841,0.01845,10,winner,loser
England,Brazil,1,0,Friendly,England,28,3,1990,1,-1,1,1943,1,0,England,Brazil,0,1,0.73715,0.18273,10,winner,loser
Germany,Uruguay,3,3,Friendly,Germany,25,4,1990,0,0,6,1944,1,1,Germany,Uruguay,0,0,0.11106,0.5788,10,draw,draw
Costa Rica,Poland,0,2,Friendly,United States,6,5,1990,-2,2,2,1945,1,0,Costa_Rica,Poland,0,2,0.59659,0.78917,10,loser,winner
Switzerland,Argentina,1,1,Friendly,Switzerland,8,5,1990,0,0,2,1946,0,1,Switzerland,Argentina,0,0,0.20675,0.27239,10,draw,draw
United States,Poland,3,1,Friendly,United States,9,5,1990,2,-2,4,1947,0,0,United_States,Poland,0,2,0.60202,0.96808,10,winner,loser
Canada,Mexico,2,1,NAFU Championship,Canada,13,5,1990,1,-1,3,1948,0,1,Canada,Mexico,0,1,0.1754,0.02868,10,winner,loser
England,Denmark,1,0,Friendly,England,15,5,1990,1,-1,1,1949,1,1,England,Denmark,0,1,0.27796,0.50913,10,winner,loser
Wales,Costa Rica,1,0,Friendly,Wales,20,5,1990,1,-1,1,1950,0,1,Wales,Costa_Rica,0,1,0.84112,0.87548,10,winner,loser
England,Uruguay,1,2,Friendly,England,22,5,1990,-1,1,3,1951,1,1,England,Uruguay,0,1,0.12914,0.24302,10,loser,winner
Germany,Denmark,1,0,Friendly,Germany,30,5,1990,1,-1,1,1952,1,1,Germany,Denmark,0,1,0.24966,0.65661,10,winner,loser
Belgium,Mexico,3,0,Friendly,Belgium,2,6,1990,3,-3,3,1953,1,1,Belgium,Mexico,0,3,0.14097,0.95088,10,winner,loser
Switzerland,United States,2,1,Friendly,Switzerland,2,6,1990,1,-1,3,1954,0,0,Switzerland,United_States,0,1,0.21353,0.10253,10,winner,loser
Tunisia,England,1,1,Friendly,Tunisia,2,6,1990,0,0,2,1955,1,1,Tunisia,England,0,0,0.16916,0.84431,10,draw,draw
Belgium,Poland,1,1,Friendly,Belgium,6,6,1990,0,0,2,1956,1,0,Belgium,Poland,0,0,0.02543,0.88508,10,draw,draw
Argentina,Cameroon,0,1,FIFA World Cup,Italy,8,6,1990,-1,1,1,1957,1,1,Argentina,Cameroon,0,1,0.0381,0.65839,10,loser,winner
Belgium,South Korea,2,0,FIFA World Cup,Italy,12,6,1990,2,-2,2,1958,1,0,Belgium,South_Korea,0,2,0.29058,0.22164,10,winner,loser
Uruguay,Spain,0,0,FIFA World Cup,Italy,13,6,1990,0,0,0,1959,1,1,Uruguay,Spain,0,0,0.18545,0.89529,10,draw,draw
Brazil,Costa Rica,1,0,FIFA World Cup,Italy,16,6,1990,1,-1,1,1960,0,1,Brazil,Costa_Rica,0,1,0.05398,0.82518,10,winner,loser
England,Netherlands,0,0,FIFA World Cup,Italy,16,6,1990,0,0,0,1961,1,1,England,Netherlands,0,0,0.05519,0.69246,10,draw,draw
Belgium,Uruguay,3,1,FIFA World Cup,Italy,17,6,1990,2,-2,4,1962,1,1,Belgium,Uruguay,0,2,0.75496,0.83836,10,winner,loser
South Korea,Spain,1,3,FIFA World Cup,Italy,17,6,1990,-2,2,4,1963,0,1,South_Korea,Spain,0,2,0.75287,0.4476,10,loser,winner
Belgium,Spain,1,2,FIFA World Cup,Italy,21,6,1990,-1,1,3,1964,1,1,Belgium,Spain,0,1,0.31324,0.56565,10,loser,winner
South Korea,Uruguay,0,1,FIFA World Cup,Italy,21,6,1990,-1,1,1,1965,0,1,South_Korea,Uruguay,0,1,0.84899,0.41221,10,loser,winner
Brazil,Argentina,0,1,FIFA World Cup,Italy,24,6,1990,-1,1,1,1966,0,1,Brazil,Argentina,0,1,0.12252,0.83577,10,loser,winner
Germany,Netherlands,2,1,FIFA World Cup,Italy,24,6,1990,1,-1,3,1967,1,1,Germany,Netherlands,0,1,0.26748,0.49432,10,winner,loser
England,Belgium,1,0,FIFA World Cup,Italy,26,6,1990,1,-1,1,1968,1,1,England,Belgium,0,1,0.97764,0.817,10,winner,loser
Cameroon,England,2,3,FIFA World Cup,Italy,1,7,1990,-1,1,5,1969,1,1,Cameroon,England,0,1,0.43527,0.69853,10,loser,winner
Germany,England,1,1,FIFA World Cup,Italy,4,7,1990,0,0,2,1970,1,1,Germany,England,0,0,0.36297,0.29547,10,draw,draw
Germany,Argentina,1,0,FIFA World Cup,Italy,8,7,1990,1,-1,1,1971,1,1,Germany,Argentina,0,1,0.48215,0.52556,10,winner,loser
Japan,South Korea,0,2,Dynasty Cup,China PR,27,7,1990,-2,2,2,1972,0,0,Japan,South_Korea,0,2,0.66701,0.02651,10,loser,winner
Tunisia,Morocco,0,0,Friendly,Tunisia,9,8,1990,0,0,0,1973,1,0,Tunisia,Morocco,0,0,0.77135,0.41103,10,draw,draw
France,Poland,0,0,Friendly,France,15,8,1990,0,0,0,1974,0,0,France,Poland,0,0,0.10318,0.43974,10,draw,draw
Portugal,Germany,1,1,Friendly,Portugal,29,8,1990,0,0,2,1975,1,1,Portugal,Germany,0,0,0.26683,0.88799,10,draw,draw
South Korea,Australia,1,0,Friendly,South Korea,6,9,1990,1,-1,1,1976,0,0,South_Korea,Australia,0,1,0.57601,0.31153,10,winner,loser
South Korea,Australia,1,0,Friendly,South Korea,9,9,1990,1,-1,1,1977,0,0,South_Korea,Australia,0,1,0.52483,0.55082,10,winner,loser
Denmark,Wales,1,0,Friendly,Denmark,11,9,1990,1,-1,1,1978,1,0,Denmark,Wales,0,1,0.97565,0.98848,10,winner,loser
Spain,Brazil,3,0,Friendly,Spain,12,9,1990,3,-3,3,1979,1,0,Spain,Brazil,0,3,0.29311,0.04359,10,winner,loser
Poland,United States,2,3,Friendly,Poland,10,10,1990,-1,1,5,1980,0,0,Poland,United_States,0,1,0.75222,0.45357,10,loser,winner
Croatia,United States,2,1,Friendly,Croatia,17,10,1990,1,-1,3,1981,0,0,Croatia,United_States,0,1,0.69373,0.5117,10,winner,loser
England,Poland,2,0,UEFA Euro qualification,England,17,10,1990,2,-2,2,1982,1,0,England,Poland,0,2,0.8257,0.475,10,winner,loser
Portugal,Netherlands,1,0,UEFA Euro qualification,Portugal,17,10,1990,1,-1,1,1983,1,1,Portugal,Netherlands,0,1,0.79047,0.07627,10,winner,loser
Wales,Belgium,3,1,UEFA Euro qualification,Wales,17,10,1990,2,-2,4,1984,0,1,Wales,Belgium,0,2,0.30286,0.71721,10,winner,loser
Mexico,Brazil,0,0,Friendly,United States,12,12,1990,0,0,0,1985,1,0,Mexico,Brazil,0,0,0.73196,0.96821,10,draw,draw
Germany,Switzerland,4,0,Friendly,Germany,19,12,1990,4,-4,4,1986,1,0,Germany,Switzerland,0,4,0.46563,0.12014,10,winner,loser
Portugal,United States,1,0,Friendly,Portugal,19,12,1990,1,-1,1,1987,1,0,Portugal,United_States,0,1,0.50833,0.05024,10,winner,loser
Spain,Portugal,1,1,Friendly,Spain,16,1,1991,0,0,2,1988,1,1,Spain,Portugal,1,0,0.39389,0.48029,10,draw,draw
United States,Switzerland,0,1,Friendly,United States,1,2,1991,-1,1,1,1989,0,0,United_States,Switzerland,1,1,0.5427,0.48456,10,loser,winner
England,Cameroon,2,0,Friendly,England,6,2,1991,2,-2,2,1990,1,1,England,Cameroon,1,2,0.62034,0.99178,10,winner,loser
France,Spain,3,1,UEFA Euro qualification,France,20,2,1991,2,-2,4,1991,0,1,France,Spain,1,2,0.42459,0.80631,10,winner,loser
United States,Mexico,2,2,NAFU Championship,United States,12,3,1991,0,0,4,1992,0,1,United_States,Mexico,1,0,0.591,0.92333,10,draw,draw
Argentina,Mexico,0,0,Friendly,Argentina,13,3,1991,0,0,0,1993,1,1,Argentina,Mexico,1,0,0.47482,0.42413,10,draw,draw
Canada,Mexico,0,3,NAFU Championship,United States,14,3,1991,-3,3,3,1994,0,1,Canada,Mexico,1,3,0.93188,0.11951,10,loser,winner
United States,Canada,2,0,NAFU Championship,United States,16,3,1991,2,-2,2,1995,0,0,United_States,Canada,1,2,0.17362,0.62536,10,winner,loser
Argentina,Brazil,3,3,Friendly,Argentina,27,3,1991,0,0,6,1996,1,0,Argentina,Brazil,1,0,0.02371,0.45968,10,draw,draw
Belgium,Wales,1,1,UEFA Euro qualification,Belgium,27,3,1991,0,0,2,1997,1,0,Belgium,Wales,1,0,0.90939,0.76101,10,draw,draw
Costa Rica,Mexico,0,0,Friendly,Costa Rica,17,4,1991,0,0,0,1998,1,1,Costa_Rica,Mexico,1,0,0.02042,0.30872,10,draw,draw
Germany,Belgium,1,0,UEFA Euro qualification,Germany,1,5,1991,1,-1,1,1999,1,1,Germany,Belgium,1,1,0.21429,0.27789,10,winner,loser
United States,Uruguay,1,0,Friendly,United States,5,5,1991,1,-1,1,2000,0,1,United_States,Uruguay,1,1,0.86577,0.14833,10,winner,loser
Mexico,Uruguay,0,2,Friendly,United States,7,5,1991,-2,2,2,2001,1,1,Mexico,Uruguay,1,2,0.96975,0.98922,10,loser,winner
United States,Argentina,0,1,Friendly,United States,19,5,1991,-1,1,1,2002,0,1,United_States,Argentina,1,1,0.75542,0.16986,10,loser,winner
England,Argentina,2,2,Friendly,England,25,5,1991,0,0,4,2003,1,1,England,Argentina,1,0,0.85665,0.05561,10,draw,draw
Poland,Wales,0,0,Friendly,Poland,29,5,1991,0,0,0,2004,0,0,Poland,Wales,1,0,0.78047,0.52143,10,draw,draw
Australia,England,0,1,Friendly,Australia,1,6,1991,-1,1,1,2005,0,1,Australia,England,1,1,0.43784,0.54476,10,loser,winner
Wales,Germany,1,0,UEFA Euro qualification,Wales,5,6,1991,1,-1,1,2006,0,1,Wales,Germany,1,1,0.20529,0.02367,10,winner,loser
South Korea,Australia,0,0,Korea Cup,South Korea,14,6,1991,0,0,0,2007,0,0,South_Korea,Australia,1,0,0.41337,0.27341,10,draw,draw
Brazil,Argentina,1,1,Friendly,Brazil,27,6,1991,0,0,2,2008,0,1,Brazil,Argentina,1,0,0.62596,0.30243,10,draw,draw
Canada,Mexico,1,3,Gold Cup,United States,30,6,1991,-2,2,4,2009,0,1,Canada,Mexico,1,2,0.22369,0.07804,10,loser,winner
United States,Costa Rica,3,2,Gold Cup,United States,3,7,1991,1,-1,5,2010,0,1,United_States,Costa_Rica,1,1,0.4054,0.77183,10,winner,loser
United States,Mexico,2,0,Gold Cup,United States,5,7,1991,2,-2,2,2011,0,1,United_States,Mexico,1,2,0.80735,0.10739,10,winner,loser
Mexico,Costa Rica,2,0,Gold Cup,United States,7,7,1991,2,-2,2,2012,1,1,Mexico,Costa_Rica,1,2,0.46897,0.56493,10,winner,loser
Ecuador,Uruguay,1,1,Copa America,Chile,9,7,1991,0,0,2,2013,0,1,Ecuador,Uruguay,1,0,0.8863,0.05546,10,draw,draw
Brazil,Uruguay,1,1,Copa America,Chile,11,7,1991,0,0,2,2014,0,1,Brazil,Uruguay,1,0,0.98413,0.81456,10,draw,draw
Brazil,Ecuador,3,1,Copa America,Chile,15,7,1991,2,-2,4,2015,0,0,Brazil,Ecuador,1,2,0.5834,0.30584,10,winner,loser
Argentina,Brazil,3,2,Copa America,Chile,17,7,1991,1,-1,5,2016,1,0,Argentina,Brazil,1,1,0.08144,0.2552,10,winner,loser
Japan,South Korea,0,1,Friendly,Japan,27,7,1991,-1,1,1,2017,0,0,Japan,South_Korea,1,1,0.38939,0.1381,10,loser,winner
Poland,France,1,5,Friendly,Poland,14,8,1991,-4,4,6,2018,0,0,Poland,France,1,4,0.89526,0.01574,10,loser,winner
Spain,Uruguay,2,1,Friendly,Spain,4,9,1991,1,-1,3,2019,1,1,Spain,Uruguay,1,1,0.3459,0.65692,10,winner,loser
England,Germany,0,1,Friendly,England,11,9,1991,-1,1,1,2020,1,1,England,Germany,1,1,0.79878,0.93351,10,loser,winner
Netherlands,Poland,1,1,Friendly,Netherlands,11,9,1991,0,0,2,2021,1,0,Netherlands,Poland,1,0,0.98434,0.40767,10,draw,draw
Wales,Brazil,1,0,Friendly,Wales,11,9,1991,1,-1,1,2022,0,0,Wales,Brazil,1,1,0.45225,0.06765,10,winner,loser
Cameroon,Tunisia,0,1,Friendly,Egypt,24,9,1991,-1,1,1,2023,1,1,Cameroon,Tunisia,1,1,0.17326,0.74456,10,loser,winner
Cameroon,Tunisia,1,0,Friendly,Egypt,30,9,1991,1,-1,1,2024,1,1,Cameroon,Tunisia,1,1,0.31823,0.78601,10,winner,loser
Spain,France,1,2,UEFA Euro qualification,Spain,12,10,1991,-1,1,3,2025,1,0,Spain,France,1,1,0.94471,0.76235,10,loser,winner
Germany,Wales,4,1,UEFA Euro qualification,Germany,16,10,1991,3,-3,5,2026,1,0,Germany,Wales,1,3,0.66403,0.56847,10,winner,loser
Netherlands,Portugal,1,0,UEFA Euro qualification,Netherlands,16,10,1991,1,-1,1,2027,1,1,Netherlands,Portugal,1,1,0.2989,0.02124,10,winner,loser
Ghana,Senegal,2,3,Friendly,Ivory Coast,31,10,1991,-1,1,5,2028,0,0,Ghana,Senegal,1,1,0.00251,0.17488,10,loser,winner
Poland,England,1,1,UEFA Euro qualification,Poland,13,11,1991,0,0,2,2029,0,1,Poland,England,1,0,0.72953,0.27254,10,draw,draw
Belgium,Germany,0,1,UEFA Euro qualification,Belgium,20,11,1991,-1,1,1,2030,1,1,Belgium,Germany,1,1,0.5743,0.73515,10,loser,winner
Mexico,Uruguay,1,1,Friendly,Mexico,20,11,1991,0,0,2,2031,1,1,Mexico,Uruguay,1,0,0.13635,0.3146,10,draw,draw
United States,Costa Rica,1,1,Friendly,United States,24,11,1991,0,0,2,2032,0,1,United_States,Costa_Rica,1,0,0.78052,0.467,10,draw,draw
Costa Rica,Mexico,1,1,Friendly,United States,27,11,1991,0,0,2,2033,1,1,Costa_Rica,Mexico,1,0,0.23057,0.58428,10,draw,draw
Tunisia,Cameroon,2,2,Friendly,Tunisia,25,12,1991,0,0,4,2034,1,1,Tunisia,Cameroon,1,0,0.29202,0.34916,10,draw,draw
Cameroon,Morocco,1,0,African Cup of Nations,Senegal,12,1,1992,1,-1,1,2035,1,0,Cameroon,Morocco,2,1,0.92364,0.72685,10,winner,loser
Portugal,Spain,0,0,Friendly,Portugal,15,1,1992,0,0,0,2036,1,1,Portugal,Spain,2,0,0.16205,0.77991,10,draw,draw
Senegal,Cameroon,0,1,African Cup of Nations,Senegal,19,1,1992,-1,1,1,2037,0,1,Senegal,Cameroon,2,1,0.9117,0.38701,10,loser,winner
Costa Rica,United States,0,0,Friendly,Costa Rica,12,2,1992,0,0,0,2038,1,0,Costa_Rica,United_States,2,0,0.72951,0.65092,10,draw,draw
Portugal,Netherlands,2,0,Friendly,Portugal,12,2,1992,2,-2,2,2039,1,1,Portugal,Netherlands,2,2,0.48041,0.52232,10,winner,loser
England,France,2,0,Friendly,England,19,2,1992,2,-2,2,2040,1,0,England,France,2,2,0.81378,0.31215,10,winner,loser
Brazil,United States,3,0,Friendly,Brazil,26,2,1992,3,-3,3,2041,0,0,Brazil,United_States,2,3,0.60798,0.13172,10,winner,loser
Tunisia,Belgium,2,1,Friendly,Tunisia,26,2,1992,1,-1,3,2042,1,1,Tunisia,Belgium,2,1,0.41244,0.33847,10,winner,loser
Spain,United States,2,0,Friendly,Spain,11,3,1992,2,-2,2,2043,1,0,Spain,United_States,2,2,0.16969,0.94245,10,winner,loser
Morocco,United States,3,1,Friendly,Morocco,18,3,1992,2,-2,4,2044,0,0,Morocco,United_States,2,2,0.89079,0.90414,10,winner,loser
France,Belgium,3,3,Friendly,France,25,3,1992,0,0,6,2045,0,1,France,Belgium,2,0,0.74642,0.88496,10,draw,draw
Uruguay,Brazil,1,0,Friendly,Uruguay,30,4,1992,1,-1,1,2046,1,0,Uruguay,Brazil,2,1,0.16431,0.11519,10,winner,loser
England,Brazil,1,1,Friendly,England,17,5,1992,0,0,2,2047,1,0,England,Brazil,2,0,0.19729,0.24001,10,draw,draw
Costa Rica,Ecuador,2,1,Friendly,Costa Rica,27,5,1992,1,-1,3,2048,1,0,Costa_Rica,Ecuador,2,1,0.61709,0.7905,10,winner,loser
Switzerland,France,2,1,Friendly,Switzerland,27,5,1992,1,-1,3,2049,0,0,Switzerland,France,2,1,0.84976,0.49597,10,winner,loser
Japan,Argentina,0,1,Kirin Cup,Japan,30,5,1992,-1,1,1,2050,0,1,Japan,Argentina,2,1,0.47102,0.04964,10,loser,winner
Netherlands,Wales,4,0,Friendly,Netherlands,30,5,1992,4,-4,4,2051,1,0,Netherlands,Wales,2,4,0.01796,0.31186,10,winner,loser
Argentina,Wales,1,0,Kirin Cup,Japan,3,6,1992,1,-1,1,2052,1,0,Argentina,Wales,2,1,0.79545,0.46145,10,winner,loser
United States,Portugal,1,0,USA Cup,United States,3,6,1992,1,-1,1,2053,0,1,United_States,Portugal,2,1,0.2823,0.12885,10,winner,loser
France,Netherlands,1,1,Friendly,France,5,6,1992,0,0,2,2054,0,1,France,Netherlands,2,0,0.99086,0.00248,10,draw,draw
Japan,Wales,0,1,Kirin Cup,Japan,7,6,1992,-1,1,1,2055,0,0,Japan,Wales,2,1,0.26538,0.788,10,loser,winner
Denmark,England,0,0,UEFA Euro,Sweden,11,6,1992,0,0,0,2056,1,1,Denmark,England,2,0,0.79983,0.48158,10,draw,draw
United States,Australia,0,1,Friendly,United States,13,6,1992,-1,1,1,2057,0,0,United_States,Australia,2,1,0.07864,0.7628,10,loser,winner
France,England,0,0,UEFA Euro,Sweden,14,6,1992,0,0,0,2058,0,1,France,England,2,0,0.52039,0.46746,10,draw,draw
France,Denmark,1,2,UEFA Euro,Sweden,17,6,1992,-1,1,3,2059,0,1,France,Denmark,2,1,0.25386,0.32442,10,loser,winner
Argentina,Australia,2,0,Friendly,Argentina,18,6,1992,2,-2,2,2060,1,0,Argentina,Australia,2,2,0.49447,0.19481,10,winner,loser
Netherlands,Germany,3,1,UEFA Euro,Sweden,18,6,1992,2,-2,4,2061,1,1,Netherlands,Germany,2,2,0.63609,0.26466,10,winner,loser
Uruguay,Australia,2,0,Friendly,Uruguay,21,6,1992,2,-2,2,2062,1,0,Uruguay,Australia,2,2,0.41145,0.33052,10,winner,loser
Netherlands,Denmark,2,2,UEFA Euro,Sweden,22,6,1992,0,0,4,2063,1,1,Netherlands,Denmark,2,0,0.96368,0.52063,10,draw,draw
Denmark,Germany,2,0,UEFA Euro,Sweden,26,6,1992,2,-2,2,2064,1,1,Denmark,Germany,2,2,0.57258,0.21758,10,winner,loser
Uruguay,Ecuador,3,1,Friendly,Uruguay,4,7,1992,2,-2,4,2065,1,0,Uruguay,Ecuador,2,2,0.85902,0.08837,10,winner,loser
Australia,Croatia,1,0,Friendly,Australia,5,7,1992,1,-1,1,2066,0,0,Australia,Croatia,2,1,0.69086,0.62778,10,winner,loser
Australia,Croatia,3,1,Friendly,Australia,8,7,1992,2,-2,4,2067,0,0,Australia,Croatia,2,2,0.03108,0.80761,10,winner,loser
Australia,Croatia,0,0,Friendly,Australia,12,7,1992,0,0,0,2068,0,0,Australia,Croatia,2,0,0.33657,0.44869,10,draw,draw
Brazil,Mexico,5,0,Friendly,United States,31,7,1992,5,-5,5,2069,0,1,Brazil,Mexico,2,5,0.39821,0.79746,10,winner,loser
Uruguay,Costa Rica,2,1,Friendly,Uruguay,2,8,1992,1,-1,3,2070,1,1,Uruguay,Costa_Rica,2,1,0.67825,0.8412,10,winner,loser
United States,Brazil,0,1,Friendly,United States,2,8,1992,-1,1,1,2071,0,0,United_States,Brazil,2,1,0.94421,0.97064,10,loser,winner
Ecuador,Costa Rica,1,1,Friendly,Ecuador,6,8,1992,0,0,2,2072,0,1,Ecuador,Costa_Rica,2,0,0.22739,0.9548,10,draw,draw
Japan,South Korea,0,0,Dynasty Cup,China PR,22,8,1992,0,0,0,2073,0,0,Japan,South_Korea,2,0,0.01583,0.68357,10,draw,draw
France,Brazil,0,2,Friendly,France,26,8,1992,-2,2,2,2074,0,0,France,Brazil,2,2,0.07018,0.81775,10,loser,winner
Japan,South Korea,2,2,Dynasty Cup,China PR,29,8,1992,0,0,4,2075,0,0,Japan,South_Korea,2,0,0.10868,0.87041,10,draw,draw
Canada,United States,0,2,Friendly,Canada,3,9,1992,-2,2,2,2076,0,0,Canada,United_States,2,2,0.9056,0.75761,10,loser,winner
Denmark,Germany,1,2,Friendly,Denmark,9,9,1992,-1,1,3,2077,1,1,Denmark,Germany,2,1,0.3944,0.75083,10,loser,winner
Spain,England,1,0,Friendly,Spain,9,9,1992,1,-1,1,2078,1,1,Spain,England,2,1,0.99989,0.85342,10,winner,loser
Brazil,Costa Rica,4,2,Friendly,Brazil,23,9,1992,2,-2,6,2079,0,1,Brazil,Costa_Rica,2,2,0.87935,0.17011,10,winner,loser
Uruguay,Argentina,0,0,Copa Lipton,Uruguay,23,9,1992,0,0,0,2080,1,1,Uruguay,Argentina,2,0,0.90232,0.4659,10,draw,draw
Iran,Cameroon,1,1,Friendly,Iran,2,10,1992,0,0,2,2081,1,1,Iran,Cameroon,2,0,0.25996,0.72397,10,draw,draw
Iran,Cameroon,0,0,Friendly,Iran,4,10,1992,0,0,0,2082,1,1,Iran,Cameroon,2,0,0.29862,0.78795,10,draw,draw
Saudi Arabia,Cameroon,2,1,Friendly,Saudi Arabia,6,10,1992,1,-1,3,2083,1,1,Saudi_Arabia,Cameroon,2,1,0.94657,0.07029,10,winner,loser
United States,Canada,0,0,Friendly,United States,9,10,1992,0,0,0,2084,0,0,United_States,Canada,2,0,0.4835,0.29065,10,draw,draw
Germany,Mexico,1,1,Friendly,Germany,14,10,1992,0,0,2,2085,1,1,Germany,Mexico,2,0,0.61269,0.69834,10,draw,draw
Netherlands,Poland,2,2,FIFA World Cup qualification,Netherlands,14,10,1992,0,0,4,2086,1,0,Netherlands,Poland,2,0,0.32602,0.47809,10,draw,draw
Saudi Arabia,United States,3,0,Confederations Cup,Saudi Arabia,15,10,1992,3,-3,3,2087,1,0,Saudi_Arabia,United_States,2,3,0.67404,0.4577,10,winner,loser
Saudi Arabia,Argentina,1,3,Confederations Cup,Saudi Arabia,20,10,1992,-2,2,4,2088,1,1,Saudi_Arabia,Argentina,2,2,0.50374,0.54959,10,loser,winner
Croatia,Mexico,3,0,Friendly,Croatia,22,10,1992,3,-3,3,2089,0,1,Croatia,Mexico,2,3,0.94579,0.22724,10,winner,loser
Saudi Arabia,Qatar,1,1,AFC Asian Cup,Japan,31,10,1992,0,0,2,2090,1,0,Saudi_Arabia,Qatar,2,0,0.76926,0.58048,10,draw,draw
Japan,Iran,1,0,AFC Asian Cup,Japan,3,11,1992,1,-1,1,2091,0,1,Japan,Iran,2,1,0.13821,0.38687,10,winner,loser
Japan,Saudi Arabia,1,0,AFC Asian Cup,Japan,8,11,1992,1,-1,1,2092,0,1,Japan,Saudi_Arabia,2,1,0.37731,0.40695,10,winner,loser
Belgium,Wales,2,0,FIFA World Cup qualification,Belgium,18,11,1992,2,-2,2,2093,1,0,Belgium,Wales,2,2,0.64615,0.30472,10,winner,loser
Mexico,Costa Rica,4,0,FIFA World Cup qualification,Mexico,22,11,1992,4,-4,4,2094,1,1,Mexico,Costa_Rica,2,4,0.5432,0.24242,10,winner,loser
Brazil,Uruguay,1,2,Friendly,Brazil,25,11,1992,-1,1,3,2095,0,1,Brazil,Uruguay,2,1,0.33617,0.08247,10,loser,winner
Argentina,Poland,2,0,Friendly,Argentina,26,11,1992,2,-2,2,2096,1,0,Argentina,Poland,2,2,0.5949,0.55268,10,winner,loser
Costa Rica,Mexico,2,0,FIFA World Cup qualification,Costa Rica,29,11,1992,2,-2,2,2097,1,1,Costa_Rica,Mexico,2,2,0.7496,0.98909,10,winner,loser
Uruguay,Poland,0,1,Friendly,Uruguay,29,11,1992,-1,1,1,2098,1,0,Uruguay,Poland,2,1,0.75936,0.52485,10,loser,winner
Qatar,Saudi Arabia,0,1,Gulf Cup,Qatar,10,12,1992,-1,1,1,2099,0,1,Qatar,Saudi_Arabia,2,1,0.72273,0.17366,10,loser,winner
Brazil,Germany,3,1,Friendly,Brazil,16,12,1992,2,-2,4,2100,0,1,Brazil,Germany,2,2,0.92916,0.56698,10,winner,loser
Tunisia,Morocco,1,1,FIFA World Cup qualification,Tunisia,20,12,1992,0,0,2,2101,1,0,Tunisia,Morocco,2,0,0.57043,0.56939,10,draw,draw
Uruguay,Germany,1,4,Friendly,Uruguay,20,12,1992,-3,3,5,2102,1,1,Uruguay,Germany,2,3,0.31395,0.76787,10,loser,winner
Japan,Switzerland,1,1,Friendly,Hong Kong,23,1,1993,0,0,2,2103,0,0,Japan,Switzerland,3,0,0.23309,0.66292,10,draw,draw
Spain,Mexico,1,1,Friendly,Spain,27,1,1993,0,0,2,2104,1,1,Spain,Mexico,3,0,0.288,0.39425,10,draw,draw
United States,Denmark,2,2,Friendly,United States,30,1,1993,0,0,4,2105,0,1,United_States,Denmark,3,0,0.19708,0.58287,10,draw,draw
Argentina,Brazil,1,1,Friendly,Argentina,18,2,1993,0,0,2,2106,1,0,Argentina,Brazil,3,0,0.04195,0.92681,10,draw,draw
Argentina,Denmark,1,1,CONMEBOL-UEFA Cup of Champions,Argentina,24,2,1993,0,0,2,2107,1,1,Argentina,Denmark,3,0,0.49235,0.31777,10,draw,draw
Morocco,Tunisia,0,0,FIFA World Cup qualification,Morocco,28,2,1993,0,0,0,2108,0,1,Morocco,Tunisia,3,0,0.50994,0.63357,10,draw,draw
Canada,South Korea,0,2,Friendly,Canada,9,3,1993,-2,2,2,2109,0,0,Canada,South_Korea,3,2,0.34237,0.24065,10,loser,winner
Canada,South Korea,2,0,Friendly,Canada,11,3,1993,2,-2,2,2110,0,0,Canada,South_Korea,3,2,0.89915,0.56573,10,winner,loser
Japan,United States,3,1,Kirin Cup,Japan,14,3,1993,2,-2,4,2111,0,0,Japan,United_States,3,2,0.6567,0.38332,10,winner,loser
Brazil,Poland,2,2,Friendly,Brazil,17,3,1993,0,0,4,2112,0,0,Brazil,Poland,3,0,0.32425,0.37436,10,draw,draw
Tunisia,Switzerland,0,1,Friendly,Tunisia,17,3,1993,-1,1,1,2113,1,0,Tunisia,Switzerland,3,1,0.93544,0.72119,10,loser,winner
Costa Rica,Canada,0,1,Friendly,Costa Rica,24,3,1993,-1,1,1,2114,1,0,Costa_Rica,Canada,3,1,0.03187,0.65042,10,loser,winner
Denmark,Spain,1,0,FIFA World Cup qualification,Denmark,31,3,1993,1,-1,1,2115,1,1,Denmark,Spain,3,1,0.43459,0.30446,10,winner,loser
Switzerland,Portugal,1,1,FIFA World Cup qualification,Switzerland,31,3,1993,0,0,2,2116,0,1,Switzerland,Portugal,3,0,0.03393,0.83102,10,draw,draw
Wales,Belgium,2,0,FIFA World Cup qualification,Wales,31,3,1993,2,-2,2,2117,0,1,Wales,Belgium,3,2,0.03462,0.05912,10,winner,loser
Germany,Ghana,6,1,Friendly,Germany,14,4,1993,5,-5,7,2118,1,0,Germany,Ghana,3,5,0.0553,0.46946,10,winner,loser
Morocco,Senegal,1,0,FIFA World Cup qualification,Morocco,18,4,1993,1,-1,1,2119,0,0,Morocco,Senegal,3,1,0.93673,0.40994,10,winner,loser
Mexico,Canada,4,0,FIFA World Cup qualification,Mexico,25,4,1993,4,-4,4,2120,1,0,Mexico,Canada,3,4,0.9392,0.53294,10,winner,loser
England,Netherlands,2,2,FIFA World Cup qualification,England,28,4,1993,0,0,4,2121,1,1,England,Netherlands,3,0,0.7022,0.96157,10,draw,draw
Canada,Mexico,1,2,FIFA World Cup qualification,Canada,9,5,1993,-1,1,3,2122,0,1,Canada,Mexico,3,1,0.49447,0.64761,10,loser,winner
Poland,England,1,1,FIFA World Cup qualification,Poland,29,5,1993,0,0,2,2123,0,1,Poland,England,3,0,0.7552,0.43496,10,draw,draw
United States,Brazil,0,2,USA Cup,United States,6,6,1993,-2,2,2,2124,0,0,United_States,Brazil,3,2,0.83169,0.05623,10,loser,winner
United States,England,2,0,USA Cup,United States,9,6,1993,2,-2,2,2125,0,1,United_States,England,3,2,0.3945,0.98736,10,winner,loser
Brazil,Germany,3,3,USA Cup,United States,10,6,1993,0,0,6,2126,0,1,Brazil,Germany,3,0,0.64703,0.85467,10,draw,draw
Brazil,England,1,1,USA Cup,United States,13,6,1993,0,0,2,2127,0,1,Brazil,England,3,0,0.29842,0.77207,10,draw,draw
United States,Germany,3,4,USA Cup,United States,13,6,1993,-1,1,7,2128,0,1,United_States,Germany,3,1,0.95657,0.61975,10,loser,winner
Uruguay,United States,1,0,Copa America,Ecuador,16,6,1993,1,-1,1,2129,1,0,Uruguay,United_States,3,1,0.08191,0.24198,10,winner,loser
Ecuador,United States,2,0,Copa America,Ecuador,19,6,1993,2,-2,2,2130,0,0,Ecuador,United_States,3,2,0.88545,0.40567,10,winner,loser
England,Germany,1,2,USA Cup,United States,19,6,1993,-1,1,3,2131,1,1,England,Germany,3,1,0.09951,0.31844,10,loser,winner
Argentina,Mexico,1,1,Copa America,Ecuador,20,6,1993,0,0,2,2132,1,1,Argentina,Mexico,3,0,0.99435,0.92016,10,draw,draw
Ecuador,Uruguay,2,1,Copa America,Ecuador,22,6,1993,1,-1,3,2133,0,1,Ecuador,Uruguay,3,1,0.65952,0.40281,10,winner,loser
Brazil,Argentina,1,1,Copa America,Ecuador,27,6,1993,0,0,2,2134,0,1,Brazil,Argentina,3,0,0.98352,0.26953,10,draw,draw
Costa Rica,Mexico,0,2,Friendly,Costa Rica,29,6,1993,-2,2,2,2135,1,1,Costa_Rica,Mexico,3,2,0.01066,0.10647,10,loser,winner
Ecuador,Mexico,0,2,Copa America,Ecuador,30,6,1993,-2,2,2,2136,0,1,Ecuador,Mexico,3,2,0.38562,0.01059,10,loser,winner
Argentina,Mexico,2,1,Copa America,Ecuador,4,7,1993,1,-1,3,2137,1,1,Argentina,Mexico,3,1,0.95037,0.02336,10,winner,loser
Canada,Costa Rica,1,1,Gold Cup,Mexico,11,7,1993,0,0,2,2138,0,1,Canada,Costa_Rica,3,0,0.91438,0.88195,10,draw,draw
Mexico,Costa Rica,1,1,Gold Cup,Mexico,15,7,1993,0,0,2,2139,1,1,Mexico,Costa_Rica,3,0,0.01091,0.77938,10,draw,draw
Senegal,Morocco,1,3,FIFA World Cup qualification,Senegal,17,7,1993,-2,2,4,2140,0,0,Senegal,Morocco,3,2,0.52528,0.89698,10,loser,winner
Ecuador,Brazil,0,0,FIFA World Cup qualification,Ecuador,18,7,1993,0,0,0,2141,0,0,Ecuador,Brazil,3,0,0.55391,0.78919,10,draw,draw
Mexico,Canada,8,0,Gold Cup,Mexico,18,7,1993,8,-8,8,2142,1,0,Mexico,Canada,3,8,0.49885,0.87074,10,winner,loser
United States,Costa Rica,1,0,Gold Cup,United States,21,7,1993,1,-1,1,2143,0,1,United_States,Costa_Rica,3,1,0.87927,0.86046,10,winner,loser
Mexico,United States,4,0,Gold Cup,Mexico,25,7,1993,4,-4,4,2144,1,0,Mexico,United_States,3,4,0.94362,0.87554,10,winner,loser
Canada,Australia,2,1,FIFA World Cup qualification,Canada,31,7,1993,1,-1,3,2145,0,0,Canada,Australia,3,1,0.17143,0.2577,10,winner,loser
Uruguay,Ecuador,0,0,FIFA World Cup qualification,Uruguay,1,8,1993,0,0,0,2146,1,0,Uruguay,Ecuador,3,0,0.2048,0.97904,10,draw,draw
Brazil,Mexico,1,1,Friendly,Brazil,8,8,1993,0,0,2,2147,0,1,Brazil,Mexico,3,0,0.9163,0.32426,10,draw,draw
Australia,Canada,2,1,FIFA World Cup qualification,Australia,15,8,1993,1,-1,3,2148,0,0,Australia,Canada,3,1,0.75973,0.45817,10,winner,loser
Uruguay,Brazil,1,1,FIFA World Cup qualification,Uruguay,15,8,1993,0,0,2,2149,1,0,Uruguay,Brazil,3,0,0.18068,0.77916,10,draw,draw
Brazil,Ecuador,2,0,FIFA World Cup qualification,Brazil,22,8,1993,2,-2,2,2150,0,0,Brazil,Ecuador,3,2,0.25781,0.34068,10,winner,loser
Ecuador,Uruguay,0,1,FIFA World Cup qualification,Ecuador,5,9,1993,-1,1,1,2151,0,1,Ecuador,Uruguay,3,1,0.2857,0.75528,10,loser,winner
England,Poland,3,0,FIFA World Cup qualification,England,8,9,1993,3,-3,3,2152,1,0,England,Poland,3,3,0.92627,0.39754,10,winner,loser
Brazil,Uruguay,2,0,FIFA World Cup qualification,Brazil,19,9,1993,2,-2,2,2153,0,1,Brazil,Uruguay,3,2,0.63369,0.28859,10,winner,loser
Mexico,Cameroon,1,0,Friendly,United States,22,9,1993,1,-1,1,2154,1,1,Mexico,Cameroon,3,1,0.83076,0.56765,10,winner,loser
Tunisia,Germany,1,1,Friendly,Tunisia,22,9,1993,0,0,2,2155,1,1,Tunisia,Germany,3,0,0.22509,0.4394,10,draw,draw
Saudi Arabia,Costa Rica,1,2,Friendly,Saudi Arabia,23,9,1993,-1,1,3,2156,1,1,Saudi_Arabia,Costa_Rica,3,1,0.94151,0.10306,10,loser,winner
South Korea,Australia,1,1,Friendly,South Korea,24,9,1993,0,0,2,2157,0,0,South_Korea,Australia,3,0,0.6411,0.59762,10,draw,draw
South Korea,Australia,1,0,Friendly,South Korea,26,9,1993,1,-1,1,2158,0,0,South_Korea,Australia,3,1,0.39625,0.33014,10,winner,loser
Saudi Arabia,Costa Rica,3,2,Friendly,Saudi Arabia,27,9,1993,1,-1,5,2159,1,1,Saudi_Arabia,Costa_Rica,3,1,0.94769,0.11044,10,winner,loser
Mexico,Poland,0,0,Friendly,United States,29,9,1993,0,0,0,2160,1,0,Mexico,Poland,3,0,0.24108,0.17651,10,draw,draw
Germany,Uruguay,5,0,Friendly,Germany,13,10,1993,5,-5,5,2161,1,1,Germany,Uruguay,3,5,0.40421,0.06185,10,winner,loser
Netherlands,England,2,0,FIFA World Cup qualification,Netherlands,13,10,1993,2,-2,2,2162,1,1,Netherlands,England,3,2,0.68097,0.95791,10,winner,loser
Portugal,Switzerland,1,0,FIFA World Cup qualification,Portugal,13,10,1993,1,-1,1,2163,1,0,Portugal,Switzerland,3,1,0.99632,0.33678,10,winner,loser
United States,Mexico,1,1,Friendly,United States,13,10,1993,0,0,2,2164,0,1,United_States,Mexico,3,0,0.19703,0.95585,10,draw,draw
Saudi Arabia,Japan,0,0,FIFA World Cup qualification,Qatar,15,10,1993,0,0,0,2165,1,0,Saudi_Arabia,Japan,3,0,0.29459,0.70632,10,draw,draw
Iran,South Korea,0,3,FIFA World Cup qualification,Qatar,16,10,1993,-3,3,3,2166,1,0,Iran,South_Korea,3,3,0.08999,0.08599,10,loser,winner
Japan,Iran,1,2,FIFA World Cup qualification,Qatar,18,10,1993,-1,1,3,2167,0,1,Japan,Iran,3,1,0.63558,0.8154,10,loser,winner
South Korea,Saudi Arabia,1,1,FIFA World Cup qualification,Qatar,22,10,1993,0,0,2,2168,0,1,South_Korea,Saudi_Arabia,3,0,0.5846,0.68595,10,draw,draw
Japan,South Korea,1,0,FIFA World Cup qualification,Qatar,25,10,1993,1,-1,1,2169,0,0,Japan,South_Korea,3,1,8.40E-04,0.15508,10,winner,loser
Saudi Arabia,Iran,4,3,FIFA World Cup qualification,Qatar,28,10,1993,1,-1,7,2170,1,1,Saudi_Arabia,Iran,3,1,0.82355,0.25017,10,winner,loser
Australia,Argentina,1,1,FIFA World Cup qualification,Australia,31,10,1993,0,0,2,2171,0,1,Australia,Argentina,3,0,0.46587,0.13811,10,draw,draw
Argentina,Australia,1,0,FIFA World Cup qualification,Argentina,17,11,1993,1,-1,1,2172,1,0,Argentina,Australia,3,1,0.73667,0.36538,10,winner,loser
Germany,Brazil,2,1,Friendly,Germany,17,11,1993,1,-1,3,2173,1,0,Germany,Brazil,3,1,0.32973,0.23133,10,winner,loser
Poland,Netherlands,1,3,FIFA World Cup qualification,Poland,17,11,1993,-2,2,4,2174,0,1,Poland,Netherlands,3,2,0.91411,0.66022,10,loser,winner
Spain,Denmark,1,0,FIFA World Cup qualification,Spain,17,11,1993,1,-1,1,2175,1,1,Spain,Denmark,3,1,0.51515,0.36455,10,winner,loser
Argentina,Germany,2,1,Friendly,United States,15,12,1993,1,-1,3,2176,1,1,Argentina,Germany,3,1,0.4553,0.69976,10,winner,loser
Mexico,Brazil,0,1,Friendly,Mexico,16,12,1993,-1,1,1,2177,1,0,Mexico,Brazil,3,1,0.54751,0.85931,10,loser,winner
United States,Germany,0,3,Friendly,United States,18,12,1993,-3,3,3,2178,0,1,United_States,Germany,3,3,0.30738,0.78603,10,loser,winner
Mexico,Germany,0,0,Friendly,Mexico,22,12,1993,0,0,0,2179,1,1,Mexico,Germany,3,0,0.79021,0.91748,10,draw,draw
Ghana,Tunisia,1,1,Friendly,Ghana,31,12,1993,0,0,2,2180,0,1,Ghana,Tunisia,3,0,0.7554,0.42073,10,draw,draw
Spain,Portugal,2,2,Friendly,Spain,19,1,1994,0,0,4,2181,1,1,Spain,Portugal,4,0,0.40556,0.47538,10,draw,draw
Tunisia,Netherlands,2,2,Friendly,Tunisia,19,1,1994,0,0,4,2182,1,1,Tunisia,Netherlands,4,0,0.68611,0.75465,10,draw,draw
United States,Switzerland,1,1,Friendly,United States,22,1,1994,0,0,2,2183,0,0,United_States,Switzerland,4,0,0.68995,0.65345,10,draw,draw
Mexico,Switzerland,1,5,Friendly,United States,26,1,1994,-4,4,6,2184,1,0,Mexico,Switzerland,4,4,0.68255,0.99836,10,loser,winner
Spain,Poland,1,1,Friendly,Spain,9,2,1994,0,0,2,2185,1,0,Spain,Poland,4,0,0.19123,0.1493,10,draw,draw
United States,South Korea,1,0,Friendly,United States,5,3,1994,1,-1,1,2186,0,0,United_States,South_Korea,4,1,0.27919,0.38082,10,winner,loser
England,Denmark,1,0,Friendly,England,9,3,1994,1,-1,1,2187,1,1,England,Denmark,4,1,0.15465,0.03411,10,winner,loser
United States,South Korea,1,1,Friendly,United States,12,3,1994,0,0,2,2188,0,0,United_States,South_Korea,4,0,0.39134,0.14776,10,draw,draw
Brazil,Argentina,2,0,Friendly,Brazil,23,3,1994,2,-2,2,2189,0,1,Brazil,Argentina,4,2,0.00601,0.67111,10,winner,loser
Spain,Croatia,0,2,Friendly,Spain,23,3,1994,-2,2,2,2190,1,0,Spain,Croatia,4,2,0.9402,0.49683,10,loser,winner
Ghana,Senegal,1,0,African Cup of Nations,Tunisia,31,3,1994,1,-1,1,2191,0,0,Ghana,Senegal,4,1,0.03645,0.05725,10,winner,loser
Poland,Saudi Arabia,1,0,Friendly,France,13,4,1994,1,-1,1,2192,0,1,Poland,Saudi_Arabia,4,1,0.92259,0.36739,10,winner,loser
Tunisia,Saudi Arabia,2,0,Friendly,Tunisia,18,4,1994,2,-2,2,2193,1,1,Tunisia,Saudi_Arabia,4,2,0.75553,0.75136,10,winner,loser
Argentina,Morocco,3,1,Friendly,Argentina,20,4,1994,2,-2,4,2194,1,0,Argentina,Morocco,4,2,0.16214,0.88365,10,winner,loser
South Korea,Cameroon,2,2,Friendly,South Korea,1,5,1994,0,0,4,2195,0,1,South_Korea,Cameroon,4,0,0.76597,0.99893,10,draw,draw
South Korea,Cameroon,2,1,Friendly,South Korea,3,5,1994,1,-1,3,2196,0,1,South_Korea,Cameroon,4,1,0.62933,0.19325,10,winner,loser
Japan,Australia,1,1,Kirin Cup,Japan,22,5,1994,0,0,2,2197,0,0,Japan,Australia,4,0,0.26241,0.57362,10,draw,draw
Ecuador,Argentina,1,0,Friendly,Ecuador,25,5,1994,1,-1,1,2198,0,1,Ecuador,Argentina,4,1,0.85161,0.18569,10,winner,loser
United States,Saudi Arabia,0,0,Friendly,United States,25,5,1994,0,0,0,2199,0,1,United_States,Saudi_Arabia,4,0,0.64477,0.23755,10,draw,draw
Australia,France,0,1,Kirin Cup,Japan,26,5,1994,-1,1,1,2200,0,0,Australia,France,4,1,0.05361,0.33799,10,loser,winner
Japan,France,1,4,Kirin Cup,Japan,29,5,1994,-3,3,5,2201,0,0,Japan,France,4,3,0.918,0.06861,10,loser,winner
Canada,Morocco,1,1,Friendly,Canada,1,6,1994,0,0,2,2202,0,0,Canada,Morocco,4,0,0.08856,0.87619,10,draw,draw
Croatia,Argentina,0,0,Friendly,Croatia,4,6,1994,0,0,0,2203,0,1,Croatia,Argentina,4,0,0.94626,0.72509,10,draw,draw
United States,Mexico,1,0,Friendly,United States,4,6,1994,1,-1,1,2204,0,1,United_States,Mexico,4,1,0.86978,0.2516,10,winner,loser
Canada,Brazil,1,1,Friendly,Canada,5,6,1994,0,0,2,2205,0,0,Canada,Brazil,4,0,0.20391,0.54487,10,draw,draw
Ecuador,South Korea,2,1,Friendly,United States,5,6,1994,1,-1,3,2206,0,0,Ecuador,South_Korea,4,1,0.96463,0.41837,10,winner,loser
Canada,Germany,0,2,Friendly,Canada,8,6,1994,-2,2,2,2207,0,1,Canada,Germany,4,2,0.57121,0.92753,10,loser,winner
Canada,Spain,0,2,Friendly,Canada,10,6,1994,-2,2,2,2208,0,1,Canada,Spain,4,2,0.93693,0.8318,10,loser,winner
Canada,Netherlands,0,3,Friendly,Canada,12,6,1994,-3,3,3,2209,0,1,Canada,Netherlands,4,3,0.12475,0.22581,10,loser,winner
Spain,South Korea,2,2,FIFA World Cup,United States,17,6,1994,0,0,4,2210,1,0,Spain,South_Korea,4,0,0.03226,0.30057,10,draw,draw
United States,Switzerland,1,1,FIFA World Cup,United States,18,6,1994,0,0,2,2211,0,0,United_States,Switzerland,4,0,0.95184,0.91548,10,draw,draw
Belgium,Morocco,1,0,FIFA World Cup,United States,19,6,1994,1,-1,1,2212,1,0,Belgium,Morocco,4,1,0.39493,0.57626,10,winner,loser
Netherlands,Saudi Arabia,2,1,FIFA World Cup,United States,20,6,1994,1,-1,3,2213,1,1,Netherlands,Saudi_Arabia,4,1,0.18652,0.17527,10,winner,loser
Germany,Spain,1,1,FIFA World Cup,United States,21,6,1994,0,0,2,2214,1,1,Germany,Spain,4,0,0.73411,0.09564,10,draw,draw
Brazil,Cameroon,3,0,FIFA World Cup,United States,24,6,1994,3,-3,3,2215,0,1,Brazil,Cameroon,4,3,0.4655,0.80623,10,winner,loser
Belgium,Netherlands,1,0,FIFA World Cup,United States,25,6,1994,1,-1,1,2216,1,1,Belgium,Netherlands,4,1,0.83549,0.33963,10,winner,loser
Saudi Arabia,Morocco,2,1,FIFA World Cup,United States,25,6,1994,1,-1,3,2217,1,0,Saudi_Arabia,Morocco,4,1,0.04935,0.17342,10,winner,loser
Germany,South Korea,3,2,FIFA World Cup,United States,27,6,1994,1,-1,5,2218,1,0,Germany,South_Korea,4,1,0.46244,0.63063,10,winner,loser
Belgium,Saudi Arabia,0,1,FIFA World Cup,United States,29,6,1994,-1,1,1,2219,1,1,Belgium,Saudi_Arabia,4,1,0.02538,0.06302,10,loser,winner
Morocco,Netherlands,1,2,FIFA World Cup,United States,29,6,1994,-1,1,3,2220,0,1,Morocco,Netherlands,4,1,0.3127,0.30345,10,loser,winner
Germany,Belgium,3,2,FIFA World Cup,United States,2,7,1994,1,-1,5,2221,1,1,Germany,Belgium,4,1,0.35376,0.50063,10,winner,loser
Spain,Switzerland,3,0,FIFA World Cup,United States,2,7,1994,3,-3,3,2222,1,0,Spain,Switzerland,4,3,0.49847,0.19678,10,winner,loser
United States,Brazil,0,1,FIFA World Cup,United States,4,7,1994,-1,1,1,2223,0,0,United_States,Brazil,4,1,0.29695,0.46972,10,loser,winner
Japan,Ghana,3,2,Friendly,Japan,8,7,1994,1,-1,5,2224,0,0,Japan,Ghana,4,1,0.11212,0.35138,10,winner,loser
Netherlands,Brazil,2,3,FIFA World Cup,United States,9,7,1994,-1,1,5,2225,1,0,Netherlands,Brazil,4,1,0.87062,0.81354,10,loser,winner
Japan,Ghana,2,1,Friendly,Japan,14,7,1994,1,-1,3,2226,0,0,Japan,Ghana,4,1,0.14599,0.37064,10,winner,loser
England,United States,2,0,Friendly,England,7,9,1994,2,-2,2,2227,1,0,England,United_States,4,2,0.47454,0.12618,10,winner,loser
Japan,Australia,0,0,Friendly,Japan,27,9,1994,0,0,0,2228,0,0,Japan,Australia,4,0,0.67176,0.64984,10,draw,draw
Denmark,Belgium,3,1,UEFA Euro qualification,Denmark,12,10,1994,2,-2,4,2229,1,1,Denmark,Belgium,4,2,0.05381,0.01846,10,winner,loser
Saudi Arabia,United States,2,1,Friendly,Saudi Arabia,19,10,1994,1,-1,3,2230,1,0,Saudi_Arabia,United_States,4,1,0.25467,0.12429,10,winner,loser
Morocco,Cameroon,1,1,Friendly,Morocco,7,11,1994,0,0,2,2231,0,1,Morocco,Cameroon,4,0,0.96273,0.92916,10,draw,draw
Qatar,Saudi Arabia,1,2,Gulf Cup,United Arab Emirates,12,11,1994,-1,1,3,2232,0,1,Qatar,Saudi_Arabia,4,1,0.21211,0.12839,10,loser,winner
Poland,France,0,0,UEFA Euro qualification,Poland,16,11,1994,0,0,0,2233,0,0,Poland,France,4,0,0.31854,0.86787,10,draw,draw
Spain,Denmark,3,0,UEFA Euro qualification,Spain,16,11,1994,3,-3,3,2234,1,1,Spain,Denmark,4,3,0.40647,0.04743,10,winner,loser
Cameroon,Ghana,0,1,Simba Tournament,South Africa,30,11,1994,-1,1,1,2235,1,0,Cameroon,Ghana,4,1,0.84956,0.43177,10,loser,winner
Saudi Arabia,Poland,0,2,Friendly,Saudi Arabia,8,12,1994,-2,2,2,2236,1,0,Saudi_Arabia,Poland,4,2,0.11485,0.38741,10,loser,winner
Saudi Arabia,Poland,1,2,Friendly,Saudi Arabia,10,12,1994,-1,1,3,2237,1,0,Saudi_Arabia,Poland,4,1,0.47526,0.70193,10,loser,winner
Belgium,Spain,1,4,UEFA Euro qualification,Belgium,17,12,1994,-3,3,5,2238,1,1,Belgium,Spain,4,3,0.15358,0.649,10,loser,winner
Saudi Arabia,Costa Rica,1,3,Friendly,Saudi Arabia,17,12,1994,-2,2,4,2239,1,1,Saudi_Arabia,Costa_Rica,4,2,0.60752,0.11353,10,loser,winner
Brazil,Serbia,2,0,Friendly,Brazil,23,12,1994,2,-2,2,2240,0,1,Brazil,Serbia,4,2,0.5906,0.75327,10,winner,loser
Argentina,Serbia,1,0,Friendly,Argentina,27,12,1994,1,-1,1,2241,1,1,Argentina,Serbia,4,1,0.33803,0.66765,10,winner,loser
Saudi Arabia,Mexico,0,2,Confederations Cup,Saudi Arabia,6,1,1995,-2,2,2,2242,1,1,Saudi_Arabia,Mexico,5,2,0.29137,0.80665,10,loser,winner
Senegal,Tunisia,0,0,African Cup of Nations qualification,Senegal,7,1,1995,0,0,0,2243,0,1,Senegal,Tunisia,5,0,0.00649,0.06838,10,draw,draw
Japan,Argentina,1,5,Confederations Cup,Saudi Arabia,8,1,1995,-4,4,6,2244,0,1,Japan,Argentina,5,4,0.3242,0.55095,10,loser,winner
Saudi Arabia,Denmark,0,2,Confederations Cup,Saudi Arabia,8,1,1995,-2,2,2,2245,1,1,Saudi_Arabia,Denmark,5,2,0.3182,0.77797,10,loser,winner
Denmark,Mexico,1,1,Confederations Cup,Saudi Arabia,10,1,1995,0,0,2,2246,1,1,Denmark,Mexico,5,0,0.87644,0.56313,10,draw,draw
Denmark,Argentina,2,0,Confederations Cup,Saudi Arabia,13,1,1995,2,-2,2,2247,1,1,Denmark,Argentina,5,2,0.33762,0.77676,10,winner,loser
Netherlands,France,0,1,Friendly,Netherlands,18,1,1995,-1,1,1,2248,1,0,Netherlands,France,5,1,0.17171,0.77537,10,loser,winner
Spain,Uruguay,2,2,Friendly,Spain,18,1,1995,0,0,4,2249,1,1,Spain,Uruguay,5,0,0.46423,0.8003,10,draw,draw
Canada,Portugal,1,1,Friendly,Canada,26,1,1995,0,0,2,2250,0,1,Canada,Portugal,5,0,0.52023,0.90965,10,draw,draw
Mexico,Uruguay,1,0,Friendly,United States,1,2,1995,1,-1,1,2251,1,1,Mexico,Uruguay,5,1,0.58606,0.7998,10,winner,loser
South Korea,Serbia,0,1,Lunar New Year Cup,Hong Kong,4,2,1995,-1,1,1,2252,0,1,South_Korea,Serbia,5,1,0.82473,0.75011,10,loser,winner
Australia,Japan,2,1,Friendly,Australia,15,2,1995,1,-1,3,2253,0,0,Australia,Japan,5,1,0.60531,0.44669,10,winner,loser
Japan,South Korea,1,1,Dynasty Cup,Hong Kong,21,2,1995,0,0,2,2254,0,0,Japan,South_Korea,5,0,0.17589,0.23638,10,draw,draw
Netherlands,Portugal,0,1,Friendly,Netherlands,22,2,1995,-1,1,1,2255,1,1,Netherlands,Portugal,5,1,0.41111,0.1653,10,loser,winner
Spain,Germany,0,0,Friendly,Spain,22,2,1995,0,0,0,2256,1,1,Spain,Germany,5,0,0.53229,0.09925,10,draw,draw
Japan,South Korea,2,2,Dynasty Cup,Hong Kong,26,2,1995,0,0,4,2257,0,0,Japan,South_Korea,5,0,0.57587,0.81148,10,draw,draw
Morocco,Senegal,2,0,Friendly,Morocco,1,3,1995,2,-2,2,2258,0,0,Morocco,Senegal,5,2,0.77435,0.52351,10,winner,loser
United States,Uruguay,2,2,Friendly,United States,25,3,1995,0,0,4,2259,0,1,United_States,Uruguay,5,0,0.77519,0.21751,10,draw,draw
England,Uruguay,0,0,Friendly,England,29,3,1995,0,0,0,2260,1,1,England,Uruguay,5,0,0.61322,0.59543,10,draw,draw
Spain,Belgium,1,1,UEFA Euro qualification,Spain,29,3,1995,0,0,2,2261,1,1,Spain,Belgium,5,0,0.95719,0.54862,10,draw,draw
Serbia,Uruguay,1,0,Friendly,Yugoslavia,31,3,1995,1,-1,1,2262,1,1,Serbia,Uruguay,5,1,0.25957,0.1182,10,winner,loser
Belgium,United States,1,0,Friendly,Belgium,22,4,1995,1,-1,1,2263,1,0,Belgium,United_States,5,1,0.04539,0.76979,10,winner,loser
Germany,Wales,1,1,UEFA Euro qualification,Germany,26,4,1995,0,0,2,2264,1,0,Germany,Wales,5,0,0.81911,0.7255,10,draw,draw
Japan,Ecuador,3,0,Kirin Cup,Japan,28,5,1995,3,-3,3,2265,0,0,Japan,Ecuador,5,3,0.77784,0.34163,10,winner,loser
United States,Costa Rica,1,2,Friendly,United States,28,5,1995,-1,1,3,2266,0,1,United_States,Costa_Rica,5,1,0.29313,0.34685,10,loser,winner
England,Japan,2,1,Friendly,England,3,6,1995,1,-1,3,2267,1,0,England,Japan,5,1,0.04349,0.22703,10,winner,loser
South Korea,Costa Rica,1,0,Korea Cup,South Korea,5,6,1995,1,-1,1,2268,0,1,South_Korea,Costa_Rica,5,1,0.96211,0.58811,10,winner,loser
Brazil,Japan,3,0,Friendly,England,6,6,1995,3,-3,3,2269,0,0,Brazil,Japan,5,3,0.89041,0.82606,10,winner,loser
Costa Rica,Ecuador,1,2,Korea Cup,South Korea,10,6,1995,-1,1,3,2270,1,0,Costa_Rica,Ecuador,5,1,0.63792,0.78749,10,loser,winner
England,Brazil,1,3,Friendly,England,11,6,1995,-2,2,4,2271,1,0,England,Brazil,5,2,0.86431,0.14535,10,loser,winner
Australia,Ghana,2,1,Friendly,Australia,18,6,1995,1,-1,3,2272,0,0,Australia,Ghana,5,1,0.40471,0.73493,10,winner,loser
United States,Mexico,4,0,USA Cup,United States,18,6,1995,4,-4,4,2273,0,1,United_States,Mexico,5,4,0.06303,0.90889,10,winner,loser
Australia,Ghana,1,0,Friendly,Australia,21,6,1995,1,-1,1,2274,0,0,Australia,Ghana,5,1,0.35004,0.42596,10,winner,loser
Switzerland,Germany,1,2,Friendly,Switzerland,23,6,1995,-1,1,3,2275,0,1,Switzerland,Germany,5,1,0.78455,0.5755,10,loser,winner
Australia,Ghana,0,1,Friendly,Australia,24,6,1995,-1,1,1,2276,0,0,Australia,Ghana,5,1,0.50588,0.09555,10,loser,winner
Argentina,Australia,2,0,Friendly,Argentina,30,6,1995,2,-2,2,2277,1,0,Argentina,Australia,5,2,0.02376,0.13118,10,winner,loser
Brazil,Ecuador,1,0,Copa America,Uruguay,7,7,1995,1,-1,1,2278,0,0,Brazil,Ecuador,5,1,0.05351,0.42971,10,winner,loser
Uruguay,Mexico,1,1,Copa America,Uruguay,13,7,1995,0,0,2,2279,1,1,Uruguay,Mexico,5,0,0.06063,0.59888,10,draw,draw
Argentina,United States,0,3,Copa America,Uruguay,14,7,1995,-3,3,3,2280,1,0,Argentina,United_States,5,3,0.53088,0.96411,10,loser,winner
Tunisia,Senegal,4,0,African Cup of Nations qualification,Tunisia,15,7,1995,4,-4,4,2281,1,0,Tunisia,Senegal,5,4,0.01925,0.7911,10,winner,loser
Brazil,Argentina,2,2,Copa America,Uruguay,17,7,1995,0,0,4,2282,0,1,Brazil,Argentina,5,0,0.20878,0.27274,10,draw,draw
United States,Mexico,0,0,Copa America,Uruguay,17,7,1995,0,0,0,2283,0,1,United_States,Mexico,5,0,0.69547,0.42112,10,draw,draw
United States,Brazil,0,1,Copa America,Uruguay,20,7,1995,-1,1,1,2284,0,0,United_States,Brazil,5,1,0.08582,0.68334,10,loser,winner
Uruguay,Brazil,1,1,Copa America,Uruguay,23,7,1995,0,0,2,2285,1,0,Uruguay,Brazil,5,0,0.28909,0.53949,10,draw,draw
Japan,Costa Rica,3,0,Friendly,Japan,6,8,1995,3,-3,3,2286,0,1,Japan,Costa_Rica,5,3,0.25771,0.1017,10,winner,loser
Japan,Brazil,1,5,Friendly,Japan,9,8,1995,-4,4,6,2287,0,0,Japan,Brazil,5,4,0.5035,0.09755,10,loser,winner
South Korea,Brazil,0,1,Friendly,South Korea,12,8,1995,-1,1,1,2288,0,0,South_Korea,Brazil,5,1,0.76534,0.28967,10,loser,winner
France,Poland,1,1,UEFA Euro qualification,France,16,8,1995,0,0,2,2289,0,0,France,Poland,5,0,0.03022,0.21861,10,draw,draw
Belgium,Germany,1,2,Friendly,Belgium,23,8,1995,-1,1,3,2290,1,1,Belgium,Germany,5,1,0.16372,0.25554,10,loser,winner
Belgium,Denmark,1,3,UEFA Euro qualification,Belgium,6,9,1995,-2,2,4,2291,1,1,Belgium,Denmark,5,2,0.19401,0.20107,10,loser,winner
Spain,Argentina,2,1,Friendly,Spain,20,9,1995,1,-1,3,2292,1,1,Spain,Argentina,5,1,0.63597,0.97415,10,winner,loser
United States,Saudi Arabia,4,3,Friendly,United States,8,10,1995,1,-1,7,2293,0,1,United_States,Saudi_Arabia,5,1,0.52865,0.94912,10,winner,loser
Brazil,Uruguay,2,0,Friendly,Brazil,11,10,1995,2,-2,2,2294,0,1,Brazil,Uruguay,5,2,0.14745,0.03651,10,winner,loser
Denmark,Spain,1,1,UEFA Euro qualification,Denmark,11,10,1995,0,0,2,2295,1,1,Denmark,Spain,5,0,0.59892,0.68344,10,draw,draw
Mexico,Saudi Arabia,2,1,Friendly,United States,11,10,1995,1,-1,3,2296,1,1,Mexico,Saudi_Arabia,5,1,0.93535,0.64635,10,winner,loser
Wales,Germany,1,2,UEFA Euro qualification,Wales,11,10,1995,-1,1,3,2297,0,1,Wales,Germany,5,1,0.7891,0.7437,10,loser,winner
Japan,Saudi Arabia,2,1,Friendly,Japan,24,10,1995,1,-1,3,2298,0,1,Japan,Saudi_Arabia,5,1,0.09809,0.73661,10,winner,loser
Japan,Saudi Arabia,2,1,Friendly,Japan,28,10,1995,1,-1,3,2299,0,1,Japan,Saudi_Arabia,5,1,0.99965,0.13597,10,winner,loser
South Korea,Saudi Arabia,1,1,Friendly,South Korea,31,10,1995,0,0,2,2300,0,1,South_Korea,Saudi_Arabia,5,0,0.85603,0.39818,10,draw,draw
Argentina,Brazil,0,1,Friendly,Argentina,8,11,1995,-1,1,1,2301,1,0,Argentina,Brazil,5,1,0.33093,0.85931,10,loser,winner
England,Switzerland,3,1,Friendly,England,15,11,1995,2,-2,4,2302,1,0,England,Switzerland,5,2,0.1883,0.16789,10,winner,loser
Mexico,Serbia,1,4,Friendly,Mexico,16,11,1995,-3,3,5,2303,1,1,Mexico,Serbia,5,3,0.3183,0.96661,10,loser,winner
England,Portugal,1,1,Friendly,England,12,12,1995,0,0,2,2304,1,1,England,Portugal,5,0,0.40005,0.61378,10,draw,draw
Morocco,Tunisia,3,1,Friendly,Morocco,3,1,1996,2,-2,4,2305,0,1,Morocco,Tunisia,6,2,0.45445,0.88743,10,winner,loser
Saudi Arabia,Ghana,1,1,Friendly,Saudi Arabia,5,1,1996,0,0,2,2306,1,0,Saudi_Arabia,Ghana,6,0,0.38305,0.01158,10,draw,draw
Brazil,Canada,4,1,Gold Cup,United States,12,1,1996,3,-3,5,2307,0,0,Brazil,Canada,6,3,0.42682,0.56436,10,winner,loser
United States,Brazil,0,1,Gold Cup,United States,18,1,1996,-1,1,1,2308,0,0,United_States,Brazil,6,1,0.25515,0.65002,10,loser,winner
Ghana,Tunisia,2,1,African Cup of Nations,South Africa,19,1,1996,1,-1,3,2309,0,1,Ghana,Tunisia,6,1,0.46515,0.42679,10,winner,loser
Mexico,Brazil,2,0,Gold Cup,United States,21,1,1996,2,-2,2,2310,1,0,Mexico,Brazil,6,2,0.89907,0.7287,10,winner,loser
Australia,Japan,1,4,Friendly,Australia,10,2,1996,-3,3,5,2311,0,0,Australia,Japan,6,3,0.11112,0.39502,10,loser,winner
Australia,Japan,3,0,Friendly,Australia,14,2,1996,3,-3,3,2312,0,0,Australia,Japan,6,3,0.65694,0.94267,10,winner,loser
Qatar,Ecuador,1,1,Friendly,Qatar,18,2,1996,0,0,2,2313,0,0,Qatar,Ecuador,6,0,0.7067,0.47851,10,draw,draw
Japan,Poland,5,0,Lunar New Year Cup,Hong Kong,19,2,1996,5,-5,5,2314,0,0,Japan,Poland,6,5,0.08398,0.25945,10,winner,loser
Portugal,Germany,1,2,Friendly,Portugal,21,2,1996,-1,1,3,2315,1,1,Portugal,Germany,6,1,0.43304,0.67973,10,loser,winner
Qatar,Ecuador,1,2,Friendly,Qatar,25,2,1996,-1,1,3,2316,0,0,Qatar,Ecuador,6,1,0.41124,0.06666,10,loser,winner
Croatia,Poland,2,1,Friendly,Croatia,28,2,1996,1,-1,3,2317,0,0,Croatia,Poland,6,1,0.98879,0.15262,10,winner,loser
Croatia,South Korea,3,0,Friendly,Croatia,13,3,1996,3,-3,3,2318,0,0,Croatia,South_Korea,6,3,0.46432,0.35263,10,winner,loser
South Korea,Morocco,2,2,United Arab Emirates Friendship Tournament,United Arab Emirates,23,3,1996,0,0,4,2319,0,0,South_Korea,Morocco,6,0,0.43454,0.75401,10,draw,draw
Belgium,France,0,2,Friendly,Belgium,27,3,1996,-2,2,2,2320,1,0,Belgium,France,6,2,0.94206,0.05651,10,loser,winner
Brazil,Ghana,8,2,Friendly,Brazil,27,3,1996,6,-6,10,2321,0,0,Brazil,Ghana,6,6,0.14671,8.90E-04,10,winner,loser
Germany,Denmark,2,0,Friendly,Germany,27,3,1996,2,-2,2,2322,1,1,Germany,Denmark,6,2,0.10106,0.60937,10,winner,loser
England,Croatia,0,0,Friendly,England,24,4,1996,0,0,0,2323,1,0,England,Croatia,6,0,0.93514,0.59724,10,draw,draw
Netherlands,Germany,0,1,Friendly,Netherlands,24,4,1996,-1,1,1,2324,1,1,Netherlands,Germany,6,1,0.23416,0.60123,10,loser,winner
Switzerland,Wales,2,0,Friendly,Switzerland,24,4,1996,2,-2,2,2325,0,0,Switzerland,Wales,6,2,0.47553,0.98311,10,winner,loser
Iran,Qatar,2,0,Friendly,Iran,17,5,1996,2,-2,2,2326,1,0,Iran,Qatar,6,2,0.73714,0.20852,10,winner,loser
Mexico,Serbia,0,0,Kirin Cup,Japan,23,5,1996,0,0,0,2327,1,1,Mexico,Serbia,6,0,0.7662,0.69659,10,draw,draw
Japan,Serbia,1,0,Kirin Cup,Japan,26,5,1996,1,-1,1,2328,0,1,Japan,Serbia,6,1,0.23921,0.5982,10,winner,loser
Tunisia,Senegal,2,0,Friendly,Tunisia,26,5,1996,2,-2,2,2329,1,0,Tunisia,Senegal,6,2,0.14916,0.52281,10,winner,loser
Japan,Mexico,3,2,Kirin Cup,Japan,29,5,1996,1,-1,5,2330,0,1,Japan,Mexico,6,1,0.05777,0.39994,10,winner,loser
Germany,France,0,1,Friendly,Germany,1,6,1996,-1,1,1,2331,1,0,Germany,France,6,1,0.93035,0.90453,10,loser,winner
Qatar,Iran,0,1,Friendly,Qatar,1,6,1996,-1,1,1,2332,0,1,Qatar,Iran,6,1,0.55194,0.92227,10,loser,winner
Denmark,Ghana,1,0,Friendly,Denmark,2,6,1996,1,-1,1,2333,1,0,Denmark,Ghana,6,1,0.66043,0.62153,10,winner,loser
Ecuador,Argentina,2,0,FIFA World Cup qualification,Ecuador,2,6,1996,2,-2,2,2334,0,1,Ecuador,Argentina,6,2,0.47894,0.38373,10,winner,loser
Canada,Costa Rica,0,1,Friendly,Canada,5,6,1996,-1,1,1,2335,0,1,Canada,Costa_Rica,6,1,0.51608,0.31658,10,loser,winner
England,Switzerland,1,1,UEFA Euro,England,8,6,1996,0,0,2,2336,1,0,England,Switzerland,6,0,0.2058,0.70047,10,draw,draw
Denmark,Portugal,1,1,UEFA Euro,England,9,6,1996,0,0,2,2337,1,1,Denmark,Portugal,6,0,0.96181,0.31649,10,draw,draw
Switzerland,Netherlands,0,2,UEFA Euro,England,13,6,1996,-2,2,2,2338,0,1,Switzerland,Netherlands,6,2,0.40177,0.59181,10,loser,winner
France,Spain,1,1,UEFA Euro,England,15,6,1996,0,0,2,2339,0,1,France,Spain,6,0,0.46521,0.27023,10,draw,draw
Croatia,Denmark,3,0,UEFA Euro,England,16,6,1996,3,-3,3,2340,0,1,Croatia,Denmark,6,3,0.75049,0.89422,10,winner,loser
United States,Mexico,2,2,USA Cup,United States,16,6,1996,0,0,4,2341,0,1,United_States,Mexico,6,0,0.99683,0.39512,10,draw,draw
England,Netherlands,4,1,UEFA Euro,England,18,6,1996,3,-3,5,2342,1,1,England,Netherlands,6,3,0.97132,0.05547,10,winner,loser
Croatia,Portugal,0,3,UEFA Euro,England,19,6,1996,-3,3,3,2343,0,1,Croatia,Portugal,6,3,0.39427,0.64228,10,loser,winner
England,Spain,0,0,UEFA Euro,England,22,6,1996,0,0,0,2344,1,1,England,Spain,6,0,0.62601,0.72899,10,draw,draw
France,Netherlands,0,0,UEFA Euro,England,22,6,1996,0,0,0,2345,0,1,France,Netherlands,6,0,0.55287,0.95414,10,draw,draw
Germany,Croatia,2,1,UEFA Euro,England,23,6,1996,1,-1,3,2346,1,0,Germany,Croatia,6,1,0.98783,0.02887,10,winner,loser
England,Germany,1,1,UEFA Euro,England,26,6,1996,0,0,2,2347,1,1,England,Germany,6,0,0.45676,0.30819,10,draw,draw
Ecuador,Costa Rica,1,1,Friendly,Ecuador,16,8,1996,0,0,2,2348,0,1,Ecuador,Costa_Rica,6,0,0.8622,0.30186,10,draw,draw
Japan,Uruguay,5,3,Friendly,Japan,25,8,1996,2,-2,8,2349,0,1,Japan,Uruguay,6,2,0.28305,0.35906,10,winner,loser
France,Mexico,2,0,Friendly,France,31,8,1996,2,-2,2,2350,0,1,France,Mexico,6,2,0.65655,0.06018,10,winner,loser
Netherlands,Brazil,2,2,Friendly,Netherlands,31,8,1996,0,0,4,2351,1,0,Netherlands,Brazil,6,0,0.6663,0.01214,10,draw,draw
Poland,Germany,0,2,Friendly,Poland,4,9,1996,-2,2,2,2352,0,1,Poland,Germany,6,2,0.47909,0.42171,10,loser,winner
Australia,Ghana,2,0,Simba Tournament,South Africa,14,9,1996,2,-2,2,2353,0,0,Australia,Ghana,6,2,0.33034,0.51695,10,winner,loser
Wales,Netherlands,1,3,FIFA World Cup qualification,Wales,5,10,1996,-2,2,4,2354,0,1,Wales,Netherlands,6,2,0.10646,0.67806,10,loser,winner
England,Poland,2,1,FIFA World Cup qualification,England,9,10,1996,1,-1,3,2355,1,0,England,Poland,6,1,0.31244,0.19378,10,winner,loser
Saudi Arabia,Australia,0,0,Friendly,Saudi Arabia,9,10,1996,0,0,0,2356,1,0,Saudi_Arabia,Australia,6,0,0.39951,0.99291,10,draw,draw
Japan,Tunisia,1,0,Friendly,Japan,13,10,1996,1,-1,1,2357,0,1,Japan,Tunisia,6,1,0.32032,0.64416,10,winner,loser
Qatar,Saudi Arabia,2,2,Gulf Cup,Oman,19,10,1996,0,0,4,2358,0,1,Qatar,Saudi_Arabia,6,0,0.98763,0.51133,10,draw,draw
Mexico,Ecuador,0,1,Friendly,United States,23,10,1996,-1,1,1,2359,1,0,Mexico,Ecuador,6,1,0.42276,0.91735,10,loser,winner
Denmark,France,1,0,Friendly,Denmark,9,11,1996,1,-1,1,2360,1,0,Denmark,France,6,1,0.64347,0.79907,10,winner,loser
Netherlands,Wales,7,1,FIFA World Cup qualification,Netherlands,9,11,1996,6,-6,8,2361,1,0,Netherlands,Wales,6,6,0.92072,0.16826,10,winner,loser
Brazil,Cameroon,2,0,Friendly,Brazil,13,11,1996,2,-2,2,2362,0,1,Brazil,Cameroon,6,2,0.18936,0.08785,10,winner,loser
Costa Rica,United States,2,1,FIFA World Cup qualification,Costa Rica,1,12,1996,1,-1,3,2363,1,0,Costa_Rica,United_States,6,1,0.28938,0.17956,10,winner,loser
Morocco,Croatia,2,2,King Hassan II Tournament,Morocco,11,12,1996,0,0,4,2364,0,0,Morocco,Croatia,6,0,0.34531,0.45833,10,draw,draw
Saudi Arabia,Iran,0,3,AFC Asian Cup,United Arab Emirates,11,12,1996,-3,3,3,2365,1,1,Saudi_Arabia,Iran,6,3,0.50104,0.25966,10,loser,winner
Belgium,Netherlands,0,3,FIFA World Cup qualification,Belgium,14,12,1996,-3,3,3,2366,1,1,Belgium,Netherlands,6,3,0.0117,0.43775,10,loser,winner
Portugal,Germany,0,0,FIFA World Cup qualification,Portugal,14,12,1996,0,0,0,2367,1,1,Portugal,Germany,6,0,0.38759,0.833,10,draw,draw
Spain,Serbia,2,0,FIFA World Cup qualification,Spain,14,12,1996,2,-2,2,2368,1,1,Spain,Serbia,6,2,0.86625,0.30638,10,winner,loser
United States,Costa Rica,2,1,FIFA World Cup qualification,United States,14,12,1996,1,-1,3,2369,0,1,United_States,Costa_Rica,6,1,0.40241,0.74099,10,winner,loser
South Korea,Iran,2,6,AFC Asian Cup,United Arab Emirates,16,12,1996,-4,4,8,2370,0,1,South_Korea,Iran,6,4,0.07072,0.36365,10,loser,winner
Iran,Saudi Arabia,0,0,AFC Asian Cup,United Arab Emirates,19,12,1996,0,0,0,2371,1,1,Iran,Saudi_Arabia,6,0,0.55496,0.26097,10,draw,draw
Argentina,Serbia,2,3,Friendly,Argentina,28,12,1996,-1,1,5,2372,1,1,Argentina,Serbia,6,1,0.6162,0.42825,10,loser,winner
Ghana,Morocco,2,2,FIFA World Cup qualification,Ghana,12,1,1997,0,0,4,2373,0,0,Ghana,Morocco,7,0,0.86598,0.10817,10,draw,draw
Uruguay,Argentina,0,0,FIFA World Cup qualification,Uruguay,12,1,1997,0,0,0,2374,1,1,Uruguay,Argentina,7,0,0.26944,0.42347,10,draw,draw
United States,Mexico,0,2,USA Cup,United States,19,1,1997,-2,2,2,2375,0,1,United_States,Mexico,7,2,0.36543,0.31274,10,loser,winner
Australia,South Korea,2,1,Friendly,Australia,22,1,1997,1,-1,3,2376,0,0,Australia,South_Korea,7,1,0.38538,0.99986,10,winner,loser
Portugal,France,0,2,Friendly,Portugal,22,1,1997,-2,2,2,2377,1,0,Portugal,France,7,2,0.25331,0.85615,10,loser,winner
Mexico,Ecuador,3,1,Friendly,Mexico,5,2,1997,2,-2,4,2378,1,0,Mexico,Ecuador,7,2,0.04374,3.30E-04,10,winner,loser
Ecuador,Uruguay,4,0,FIFA World Cup qualification,Ecuador,12,2,1997,4,-4,4,2379,0,1,Ecuador,Uruguay,7,4,0.42835,0.56548,10,winner,loser
Brazil,Poland,4,2,Friendly,Brazil,26,2,1997,2,-2,6,2380,0,0,Brazil,Poland,7,2,0.9826,0.16608,10,winner,loser
France,Netherlands,2,1,Friendly,France,26,2,1997,1,-1,3,2381,0,1,France,Netherlands,7,1,0.37618,0.61873,10,winner,loser
Mexico,Canada,4,0,FIFA World Cup qualification,Mexico,2,3,1997,4,-4,4,2382,1,0,Mexico,Canada,7,4,0.95335,0.63473,10,winner,loser
Costa Rica,Cameroon,5,0,Friendly,Costa Rica,9,3,1997,5,-5,5,2383,1,1,Costa_Rica,Cameroon,7,5,0.26656,0.86927,10,winner,loser
Costa Rica,Mexico,0,0,FIFA World Cup qualification,Costa Rica,16,3,1997,0,0,0,2384,1,1,Costa_Rica,Mexico,7,0,0.85412,0.37891,10,draw,draw
United States,Canada,3,0,FIFA World Cup qualification,United States,16,3,1997,3,-3,3,2385,0,0,United_States,Canada,7,3,0.47256,0.94224,10,winner,loser
Costa Rica,United States,3,2,FIFA World Cup qualification,Costa Rica,23,3,1997,1,-1,5,2386,1,0,Costa_Rica,United_States,7,1,0.64304,0.40046,10,winner,loser
Croatia,Denmark,1,1,FIFA World Cup qualification,Croatia,29,3,1997,0,0,2,2387,0,1,Croatia,Denmark,7,0,0.97937,0.42659,10,draw,draw
England,Mexico,2,0,Friendly,England,29,3,1997,2,-2,2,2388,1,1,England,Mexico,7,2,0.70147,0.88546,10,winner,loser
Wales,Belgium,1,2,FIFA World Cup qualification,Wales,29,3,1997,-1,1,3,2389,0,1,Wales,Belgium,7,1,0.31562,0.18697,10,loser,winner
United States,Mexico,2,2,FIFA World Cup qualification,United States,20,4,1997,0,0,4,2390,0,1,United_States,Mexico,7,0,0.73073,0.13269,10,draw,draw
Argentina,Ecuador,2,1,FIFA World Cup qualification,Argentina,30,4,1997,1,-1,3,2391,1,0,Argentina,Ecuador,7,1,0.11754,0.17149,10,winner,loser
Brazil,Mexico,4,0,Friendly,United States,30,4,1997,4,-4,4,2392,0,1,Brazil,Mexico,7,4,0.35678,0.52364,10,winner,loser
Serbia,Spain,1,1,FIFA World Cup qualification,Yugoslavia,30,4,1997,0,0,2,2393,1,1,Serbia,Spain,7,0,0.17333,0.3441,10,draw,draw
Japan,South Korea,1,1,Friendly,Japan,21,5,1997,0,0,2,2394,0,0,Japan,South_Korea,7,0,0.39935,0.46944,10,draw,draw
Poland,England,0,2,FIFA World Cup qualification,Poland,31,5,1997,-2,2,2,2395,0,1,Poland,England,7,2,0.09746,0.56158,10,loser,winner
Canada,Costa Rica,1,0,FIFA World Cup qualification,Canada,1,6,1997,1,-1,1,2396,0,1,Canada,Costa_Rica,7,1,0.33294,0.14071,10,winner,loser
France,Brazil,1,1,Tournoi de France,France,3,6,1997,0,0,2,2397,0,0,France,Brazil,7,0,0.54617,0.41161,10,draw,draw
France,England,0,1,Tournoi de France,France,7,6,1997,-1,1,1,2398,0,1,France,England,7,1,0.02689,0.52111,10,loser,winner
Morocco,Ghana,1,0,FIFA World Cup qualification,Morocco,7,6,1997,1,-1,1,2399,0,0,Morocco,Ghana,7,1,0.06683,0.42421,10,winner,loser
Japan,Croatia,4,3,Kirin Cup,Japan,8,6,1997,1,-1,7,2400,0,0,Japan,Croatia,7,1,0.87852,0.65247,10,winner,loser
England,Brazil,0,1,Tournoi de France,France,10,6,1997,-1,1,1,2401,1,0,England,Brazil,7,1,0.8415,0.61194,10,loser,winner
Argentina,Ecuador,0,0,Copa America,Bolivia,11,6,1997,0,0,0,2402,1,0,Argentina,Ecuador,7,0,0.30207,0.22383,10,draw,draw
Ghana,Serbia,1,3,Korea Cup,South Korea,12,6,1997,-2,2,4,2403,0,1,Ghana,Serbia,7,2,0.08943,0.30653,10,loser,winner
Brazil,Costa Rica,5,0,Copa America,Bolivia,13,6,1997,5,-5,5,2404,0,1,Brazil,Costa_Rica,7,5,0.75029,0.94147,10,winner,loser
South Korea,Ghana,3,0,Korea Cup,South Korea,14,6,1997,3,-3,3,2405,0,0,South_Korea,Ghana,7,3,0.95916,0.26289,10,winner,loser
Brazil,Mexico,3,2,Copa America,Bolivia,16,6,1997,1,-1,5,2406,0,1,Brazil,Mexico,7,1,0.17826,0.98786,10,winner,loser
South Korea,Serbia,1,1,Korea Cup,South Korea,16,6,1997,0,0,2,2407,0,1,South_Korea,Serbia,7,0,0.77557,0.70919,10,draw,draw
Mexico,Costa Rica,1,1,Copa America,Bolivia,19,6,1997,0,0,2,2408,1,1,Mexico,Costa_Rica,7,0,0.73975,0.04501,10,draw,draw
Ecuador,Mexico,1,1,Copa America,Bolivia,22,6,1997,0,0,2,2409,0,1,Ecuador,Mexico,7,0,0.24724,0.55031,10,draw,draw
Morocco,Senegal,3,0,African Cup of Nations qualification,Morocco,27,7,1997,3,-3,3,2410,0,0,Morocco,Senegal,7,3,0.41698,0.23185,10,winner,loser
United States,Ecuador,0,1,Friendly,United States,7,8,1997,-1,1,1,2411,0,0,United_States,Ecuador,7,1,0.2341,0.14625,10,loser,winner
South Korea,Brazil,1,2,Friendly,South Korea,10,8,1997,-1,1,3,2412,0,0,South_Korea,Brazil,7,1,0.57691,0.03084,10,loser,winner
Japan,Brazil,0,3,Friendly,Japan,13,8,1997,-3,3,3,2413,0,0,Japan,Brazil,7,3,0.87455,0.2337,10,loser,winner
Canada,Iran,0,1,Friendly,Canada,17,8,1997,-1,1,1,2414,0,1,Canada,Iran,7,1,0.41334,0.80207,10,loser,winner
Germany,Portugal,1,1,FIFA World Cup qualification,Germany,6,9,1997,0,0,2,2415,1,1,Germany,Portugal,7,0,0.88155,0.94119,10,draw,draw
Netherlands,Belgium,3,1,FIFA World Cup qualification,Netherlands,6,9,1997,2,-2,4,2416,1,1,Netherlands,Belgium,7,2,0.6448,0.5864,10,winner,loser
United States,Costa Rica,1,0,FIFA World Cup qualification,United States,7,9,1997,1,-1,1,2417,0,1,United_States,Costa_Rica,7,1,0.29256,0.55443,10,winner,loser
Brazil,Ecuador,4,2,Friendly,Brazil,10,9,1997,2,-2,6,2418,0,0,Brazil,Ecuador,7,2,0.58987,0.81369,10,winner,loser
Denmark,Croatia,3,1,FIFA World Cup qualification,Denmark,10,9,1997,2,-2,4,2419,1,0,Denmark,Croatia,7,2,0.7951,0.28975,10,winner,loser
Iran,Saudi Arabia,1,1,FIFA World Cup qualification,Iran,19,9,1997,0,0,2,2420,1,1,Iran,Saudi_Arabia,7,0,0.46946,0.66148,10,draw,draw
Japan,South Korea,1,2,FIFA World Cup qualification,Japan,28,9,1997,-1,1,3,2421,0,0,Japan,South_Korea,7,1,0.84023,0.74599,10,loser,winner
Iran,Qatar,3,0,FIFA World Cup qualification,Iran,3,10,1997,3,-3,3,2422,1,0,Iran,Qatar,7,3,0.31769,0.58136,10,winner,loser
Brazil,Morocco,2,0,Friendly,Brazil,9,10,1997,2,-2,2,2423,0,0,Brazil,Morocco,7,2,0.69668,0.22222,10,winner,loser
Belgium,Wales,3,2,FIFA World Cup qualification,Belgium,11,10,1997,1,-1,5,2424,1,0,Belgium,Wales,7,1,0.39695,0.07149,10,winner,loser
Saudi Arabia,Qatar,1,0,FIFA World Cup qualification,Saudi Arabia,11,10,1997,1,-1,1,2425,1,0,Saudi_Arabia,Qatar,7,1,0.39809,0.9508,10,winner,loser
Argentina,Uruguay,0,0,FIFA World Cup qualification,Argentina,12,10,1997,0,0,0,2426,1,1,Argentina,Uruguay,7,0,0.879,0.41042,10,draw,draw
Canada,Mexico,2,2,FIFA World Cup qualification,Canada,12,10,1997,0,0,4,2427,0,1,Canada,Mexico,7,0,0.29827,0.71405,10,draw,draw
Saudi Arabia,Iran,1,0,FIFA World Cup qualification,Saudi Arabia,24,10,1997,1,-1,1,2428,1,1,Saudi_Arabia,Iran,7,1,0.46577,0.07373,10,winner,loser
South Korea,Japan,0,2,FIFA World Cup qualification,South Korea,1,11,1997,-2,2,2,2429,0,0,South_Korea,Japan,7,2,0.14969,0.75974,10,loser,winner
Mexico,United States,0,0,FIFA World Cup qualification,Mexico,2,11,1997,0,0,0,2430,1,0,Mexico,United_States,7,0,0.88584,0.22328,10,draw,draw
Qatar,Iran,2,0,FIFA World Cup qualification,Qatar,7,11,1997,2,-2,2,2431,0,1,Qatar,Iran,7,2,0.8286,0.7691,10,winner,loser
Canada,United States,0,3,FIFA World Cup qualification,Canada,9,11,1997,-3,3,3,2432,0,0,Canada,United_States,7,3,0.15093,0.30238,10,loser,winner
Mexico,Costa Rica,3,3,FIFA World Cup qualification,Mexico,9,11,1997,0,0,6,2433,1,1,Mexico,Costa_Rica,7,0,0.05819,0.07236,10,draw,draw
Brazil,Wales,3,0,Friendly,Brazil,11,11,1997,3,-3,3,2434,0,0,Brazil,Wales,7,3,0.19635,0.96672,10,winner,loser
Qatar,Saudi Arabia,0,1,FIFA World Cup qualification,Qatar,12,11,1997,-1,1,1,2435,0,1,Qatar,Saudi_Arabia,7,1,0.13786,0.69512,10,loser,winner
England,Cameroon,2,0,Friendly,England,15,11,1997,2,-2,2,2436,1,1,England,Cameroon,7,2,0.96285,0.14269,10,winner,loser
Costa Rica,Canada,3,1,FIFA World Cup qualification,Costa Rica,16,11,1997,2,-2,4,2437,1,0,Costa_Rica,Canada,7,2,0.24042,0.41233,10,winner,loser
Japan,Iran,3,2,FIFA World Cup qualification,Malaysia,16,11,1997,1,-1,5,2438,0,1,Japan,Iran,7,1,0.48447,0.63466,10,winner,loser
Uruguay,Ecuador,5,3,FIFA World Cup qualification,Uruguay,16,11,1997,2,-2,8,2439,1,0,Uruguay,Ecuador,7,2,0.5713,0.67265,10,winner,loser
Iran,Australia,1,1,FIFA World Cup qualification,Iran,22,11,1997,0,0,2,2440,1,0,Iran,Australia,7,0,0.18715,0.06566,10,draw,draw
Australia,Iran,2,2,FIFA World Cup qualification,Australia,29,11,1997,0,0,4,2441,0,1,Australia,Iran,7,0,0.67652,0.7791,10,draw,draw
Mexico,Australia,1,3,Confederations Cup,Saudi Arabia,12,12,1997,-2,2,4,2442,1,0,Mexico,Australia,7,2,0.55875,0.4056,10,loser,winner
Saudi Arabia,Brazil,0,3,Confederations Cup,Saudi Arabia,12,12,1997,-3,3,3,2443,1,0,Saudi_Arabia,Brazil,7,3,0.58083,0.73364,10,loser,winner
Australia,Brazil,0,0,Confederations Cup,Saudi Arabia,14,12,1997,0,0,0,2444,0,0,Australia,Brazil,7,0,0.77865,0.05435,10,draw,draw
Saudi Arabia,Mexico,0,5,Confederations Cup,Saudi Arabia,14,12,1997,-5,5,5,2445,1,1,Saudi_Arabia,Mexico,7,5,0.66236,0.55826,10,loser,winner
Brazil,Mexico,3,2,Confederations Cup,Saudi Arabia,16,12,1997,1,-1,5,2446,0,1,Brazil,Mexico,7,1,0.62885,0.18964,10,winner,loser
Saudi Arabia,Australia,1,0,Confederations Cup,Saudi Arabia,16,12,1997,1,-1,1,2447,1,0,Saudi_Arabia,Australia,7,1,0.80564,0.77477,10,winner,loser
Uruguay,Australia,0,1,Confederations Cup,Saudi Arabia,19,12,1997,-1,1,1,2448,1,0,Uruguay,Australia,7,1,9.90E-04,0.16528,10,loser,winner
Brazil,Australia,6,0,Confederations Cup,Saudi Arabia,21,12,1997,6,-6,6,2449,0,0,Brazil,Australia,7,6,0.1475,0.43594,10,winner,loser
France,Spain,1,0,Friendly,France,28,1,1998,1,-1,1,2450,0,1,France,Spain,8,1,0.9375,0.21337,10,winner,loser
Tunisia,Serbia,0,3,Friendly,Tunisia,28,1,1998,-3,3,3,2451,1,1,Tunisia,Serbia,8,3,0.62294,0.35739,10,loser,winner
United States,Costa Rica,2,1,Gold Cup,United States,7,2,1998,1,-1,3,2452,0,1,United_States,Costa_Rica,8,1,0.2355,0.18321,10,winner,loser
Ghana,Tunisia,2,0,African Cup of Nations,Burkina Faso,9,2,1998,2,-2,2,2453,0,1,Ghana,Tunisia,8,2,0.25652,0.59031,10,winner,loser
United States,Brazil,1,0,Gold Cup,United States,10,2,1998,1,-1,1,2454,0,0,United_States,Brazil,8,1,0.6848,0.52261,10,winner,loser
Australia,South Korea,1,0,Friendly,Australia,11,2,1998,1,-1,1,2455,0,0,Australia,South_Korea,8,1,0.79898,0.2082,10,winner,loser
Australia,Japan,0,3,Friendly,Australia,15,2,1998,-3,3,3,2456,0,0,Australia,Japan,8,3,0.68093,0.80321,10,loser,winner
United States,Mexico,0,1,Gold Cup,United States,15,2,1998,-1,1,1,2457,0,1,United_States,Mexico,8,1,0.21129,0.47655,10,loser,winner
United States,Netherlands,0,2,Friendly,United States,21,2,1998,-2,2,2,2458,0,1,United_States,Netherlands,8,2,0.50548,0.69286,10,loser,winner
Saudi Arabia,Germany,0,3,Friendly,Saudi Arabia,22,2,1998,-3,3,3,2459,1,1,Saudi_Arabia,Germany,8,3,0.43352,0.12882,10,loser,winner
Argentina,Serbia,3,1,Friendly,Argentina,24,2,1998,2,-2,4,2460,1,1,Argentina,Serbia,8,2,0.82473,0.68919,10,winner,loser
Mexico,Netherlands,2,3,Friendly,United States,24,2,1998,-1,1,5,2461,1,1,Mexico,Netherlands,8,1,0.44892,0.84145,10,loser,winner
Belgium,United States,2,0,Friendly,Belgium,25,2,1998,2,-2,2,2462,1,0,Belgium,United_States,8,2,0.36097,0.54633,10,winner,loser
Japan,South Korea,2,1,Dynasty Cup,Japan,1,3,1998,1,-1,3,2463,0,0,Japan,South_Korea,8,1,0.06461,0.77645,10,winner,loser
Germany,Brazil,1,2,Friendly,Germany,25,3,1998,-1,1,3,2464,1,0,Germany,Brazil,8,1,0.60802,0.19617,10,loser,winner
Switzerland,England,1,1,Friendly,Switzerland,25,3,1998,0,0,2,2465,0,1,Switzerland,England,8,0,0.76217,0.76826,10,draw,draw
South Korea,Japan,2,1,Friendly,South Korea,1,4,1998,1,-1,3,2466,0,0,South_Korea,Japan,8,1,0.93286,0.43178,10,winner,loser
Croatia,Poland,4,1,Friendly,Croatia,22,4,1998,3,-3,5,2467,0,0,Croatia,Poland,8,3,0.0386,0.4216,10,winner,loser
England,Portugal,3,0,Friendly,England,22,4,1998,3,-3,3,2468,1,1,England,Portugal,8,3,0.90637,0.71935,10,winner,loser
Serbia,South Korea,3,1,Friendly,Yugoslavia,22,4,1998,2,-2,4,2469,1,0,Serbia,South_Korea,8,2,0.539,0.20207,10,winner,loser
Brazil,Argentina,0,1,Friendly,Brazil,29,4,1998,-1,1,1,2470,0,1,Brazil,Argentina,8,1,0.68465,0.10257,10,loser,winner
England,Saudi Arabia,0,0,Friendly,England,23,5,1998,0,0,0,2471,1,1,England,Saudi_Arabia,8,0,0.27546,0.37568,10,draw,draw
Belgium,France,0,1,King Hassan II Tournament,Morocco,27,5,1998,-1,1,1,2472,1,0,Belgium,France,8,1,0.9355,0.64407,10,loser,winner
Morocco,England,0,1,King Hassan II Tournament,Morocco,27,5,1998,-1,1,1,2473,0,1,Morocco,England,8,1,0.81611,0.62756,10,loser,winner
Netherlands,Cameroon,0,0,Friendly,Netherlands,27,5,1998,0,0,0,2474,1,1,Netherlands,Cameroon,8,0,0.77913,0.65592,10,draw,draw
Belgium,England,0,0,King Hassan II Tournament,Morocco,29,5,1998,0,0,0,2475,1,1,Belgium,England,8,0,0.82585,0.9815,10,draw,draw
Morocco,France,2,2,King Hassan II Tournament,Morocco,29,5,1998,0,0,4,2476,0,0,Morocco,France,8,0,0.42751,0.62314,10,draw,draw
Japan,Mexico,1,2,Friendly,Switzerland,31,5,1998,-1,1,3,2477,0,1,Japan,Mexico,8,1,0.07334,0.03912,10,loser,winner
Croatia,Iran,2,0,Friendly,Croatia,3,6,1998,2,-2,2,2478,0,1,Croatia,Iran,8,2,0.17811,0.65709,10,winner,loser
Saudi Arabia,Mexico,0,0,Friendly,France,3,6,1998,0,0,0,2479,1,1,Saudi_Arabia,Mexico,8,0,0.29296,0.93928,10,draw,draw
Serbia,Japan,1,0,Friendly,Switzerland,3,6,1998,1,-1,1,2480,1,0,Serbia,Japan,8,1,0.67553,0.84697,10,winner,loser
Denmark,Cameroon,1,2,Friendly,Denmark,5,6,1998,-1,1,3,2481,1,1,Denmark,Cameroon,8,1,0.42875,0.70565,10,loser,winner
Croatia,Australia,7,0,Friendly,Croatia,6,6,1998,7,-7,7,2482,0,0,Croatia,Australia,8,7,0.87383,0.50428,10,winner,loser
Switzerland,Serbia,1,1,Friendly,Switzerland,6,6,1998,0,0,2,2483,0,1,Switzerland,Serbia,8,0,0.80695,0.00528,10,draw,draw
Tunisia,Wales,4,0,Friendly,Tunisia,6,6,1998,4,-4,4,2484,1,0,Tunisia,Wales,8,4,0.43369,0.53194,10,winner,loser
Saudi Arabia,Denmark,0,1,FIFA World Cup,France,12,6,1998,-1,1,1,2485,1,1,Saudi_Arabia,Denmark,8,1,0.06888,0.53361,10,loser,winner
South Korea,Mexico,1,3,FIFA World Cup,France,13,6,1998,-2,2,4,2486,0,1,South_Korea,Mexico,8,2,0.47236,0.70753,10,loser,winner
Netherlands,Belgium,0,0,FIFA World Cup,France,13,6,1998,0,0,0,2487,1,1,Netherlands,Belgium,8,0,0.82645,0.76133,10,draw,draw
Argentina,Japan,1,0,FIFA World Cup,France,14,6,1998,1,-1,1,2488,1,0,Argentina,Japan,8,1,0.52037,0.2961,10,winner,loser
Serbia,Iran,1,0,FIFA World Cup,France,14,6,1998,1,-1,1,2489,1,1,Serbia,Iran,8,1,0.47907,0.98989,10,winner,loser
England,Tunisia,2,0,FIFA World Cup,France,15,6,1998,2,-2,2,2490,1,1,England,Tunisia,8,2,0.13433,0.28778,10,winner,loser
Germany,United States,2,0,FIFA World Cup,France,15,6,1998,2,-2,2,2491,1,0,Germany,United_States,8,2,0.14177,0.99364,10,winner,loser
Brazil,Morocco,3,0,FIFA World Cup,France,16,6,1998,3,-3,3,2492,0,0,Brazil,Morocco,8,3,0.79778,0.55207,10,winner,loser
France,Saudi Arabia,4,0,FIFA World Cup,France,18,6,1998,4,-4,4,2493,0,1,France,Saudi_Arabia,8,4,0.67846,0.98879,10,winner,loser
Belgium,Mexico,2,2,FIFA World Cup,France,20,6,1998,0,0,4,2494,1,1,Belgium,Mexico,8,0,0.75873,0.28482,10,draw,draw
Japan,Croatia,0,1,FIFA World Cup,France,20,6,1998,-1,1,1,2495,0,0,Japan,Croatia,8,1,0.57146,0.99207,10,loser,winner
Netherlands,South Korea,5,0,FIFA World Cup,France,20,6,1998,5,-5,5,2496,1,0,Netherlands,South_Korea,8,5,0.67469,0.42699,10,winner,loser
Germany,Serbia,2,2,FIFA World Cup,France,21,6,1998,0,0,4,2497,1,1,Germany,Serbia,8,0,0.10739,0.94941,10,draw,draw
United States,Iran,1,2,FIFA World Cup,France,21,6,1998,-1,1,3,2498,0,1,United_States,Iran,8,1,0.34769,0.98326,10,loser,winner
France,Denmark,2,1,FIFA World Cup,France,24,6,1998,1,-1,3,2499,0,1,France,Denmark,8,1,0.55295,0.11971,10,winner,loser
Belgium,South Korea,1,1,FIFA World Cup,France,25,6,1998,0,0,2,2500,1,0,Belgium,South_Korea,8,0,0.13518,0.68741,10,draw,draw
Germany,Iran,2,0,FIFA World Cup,France,25,6,1998,2,-2,2,2501,1,1,Germany,Iran,8,2,0.13275,0.35778,10,winner,loser
Netherlands,Mexico,2,2,FIFA World Cup,France,25,6,1998,0,0,4,2502,1,1,Netherlands,Mexico,8,0,0.40396,0.55167,10,draw,draw
United States,Serbia,0,1,FIFA World Cup,France,25,6,1998,-1,1,1,2503,0,1,United_States,Serbia,8,1,0.09189,0.88428,10,loser,winner
Argentina,Croatia,1,0,FIFA World Cup,France,26,6,1998,1,-1,1,2504,1,0,Argentina,Croatia,8,1,0.94906,0.50658,10,winner,loser
Germany,Mexico,2,1,FIFA World Cup,France,29,6,1998,1,-1,3,2505,1,1,Germany,Mexico,8,1,0.39001,0.83476,10,winner,loser
Netherlands,Serbia,2,1,FIFA World Cup,France,29,6,1998,1,-1,3,2506,1,1,Netherlands,Serbia,8,1,0.84173,0.72468,10,winner,loser
Argentina,England,2,2,FIFA World Cup,France,30,6,1998,0,0,4,2507,1,1,Argentina,England,8,0,0.91218,0.48443,10,draw,draw
Brazil,Denmark,3,2,FIFA World Cup,France,3,7,1998,1,-1,5,2508,0,1,Brazil,Denmark,8,1,0.10535,0.51504,10,winner,loser
Germany,Croatia,0,3,FIFA World Cup,France,4,7,1998,-3,3,3,2509,1,0,Germany,Croatia,8,3,0.22401,0.76657,10,loser,winner
Netherlands,Argentina,2,1,FIFA World Cup,France,4,7,1998,1,-1,3,2510,1,1,Netherlands,Argentina,8,1,0.63488,0.10095,10,winner,loser
Brazil,Netherlands,1,1,FIFA World Cup,France,7,7,1998,0,0,2,2511,0,1,Brazil,Netherlands,8,0,0.65199,0.29083,10,draw,draw
France,Croatia,2,1,FIFA World Cup,France,8,7,1998,1,-1,3,2512,0,0,France,Croatia,8,1,0.90128,0.6697,10,winner,loser
Netherlands,Croatia,1,2,FIFA World Cup,France,11,7,1998,-1,1,3,2513,1,0,Netherlands,Croatia,8,1,0.45976,0.01709,10,loser,winner
France,Brazil,3,0,FIFA World Cup,France,12,7,1998,3,-3,3,2514,0,0,France,Brazil,8,3,0.01271,0.82702,10,winner,loser
Morocco,Senegal,2,0,Friendly,Morocco,2,9,1998,2,-2,2,2515,0,0,Morocco,Senegal,8,2,0.58457,0.19859,10,winner,loser
Serbia,Switzerland,1,1,Friendly,Yugoslavia,2,9,1998,0,0,2,2516,1,0,Serbia,Switzerland,8,0,0.06031,0.41002,10,draw,draw
Saudi Arabia,Senegal,3,2,Friendly,Saudi Arabia,17,9,1998,1,-1,5,2517,1,0,Saudi_Arabia,Senegal,8,1,0.43615,0.37614,10,winner,loser
Brazil,Serbia,1,1,Friendly,Brazil,23,9,1998,0,0,2,2518,0,1,Brazil,Serbia,8,0,0.54705,0.07461,10,draw,draw
Qatar,Saudi Arabia,1,3,Arab Cup,Qatar,1,10,1998,-2,2,4,2519,0,1,Qatar,Saudi_Arabia,8,2,0.24964,0.97586,10,loser,winner
Cameroon,Ghana,1,3,African Cup of Nations qualification,Cameroon,4,10,1998,-2,2,4,2520,1,0,Cameroon,Ghana,8,2,0.16674,0.98666,10,loser,winner
Denmark,Wales,1,2,UEFA Euro qualification,Denmark,10,10,1998,-1,1,3,2521,1,0,Denmark,Wales,8,1,0.98415,0.16538,10,loser,winner
Netherlands,Ghana,0,0,Friendly,Netherlands,13,10,1998,0,0,0,2522,1,0,Netherlands,Ghana,8,0,0.69304,0.22419,10,draw,draw
Brazil,Ecuador,5,1,Friendly,United States,14,10,1998,4,-4,6,2523,0,0,Brazil,Ecuador,8,4,0.88175,0.05697,10,winner,loser
Switzerland,Denmark,1,1,UEFA Euro qualification,Switzerland,14,10,1998,0,0,2,2524,0,1,Switzerland,Denmark,8,0,0.81248,0.99694,10,draw,draw
United States,Australia,0,0,Friendly,United States,6,11,1998,0,0,0,2525,0,0,United_States,Australia,8,0,0.8018,0.6886,10,draw,draw
Qatar,Saudi Arabia,0,0,Gulf Cup,Bahrain,11,11,1998,0,0,0,2526,0,1,Qatar,Saudi_Arabia,8,0,0.93196,0.51214,10,draw,draw
Germany,Netherlands,1,1,Friendly,Germany,18,11,1998,0,0,2,2527,1,1,Germany,Netherlands,8,0,0.7076,0.72475,10,draw,draw
France,Morocco,1,0,Friendly,France,20,1,1999,1,-1,1,2528,0,0,France,Morocco,9,1,0.63633,0.73043,10,winner,loser
Costa Rica,Ecuador,0,0,Friendly,Costa Rica,28,1,1999,0,0,0,2529,1,0,Costa_Rica,Ecuador,9,0,0.07459,0.22697,10,draw,draw
United States,Germany,3,0,Friendly,United States,6,2,1999,3,-3,3,2530,0,1,United_States,Germany,9,3,0.31222,0.47272,10,winner,loser
Croatia,Denmark,0,1,Friendly,Croatia,10,2,1999,-1,1,1,2531,0,1,Croatia,Denmark,9,1,0.28192,0.84485,10,loser,winner
England,France,0,2,Friendly,England,10,2,1999,-2,2,2,2532,1,0,England,France,9,2,0.71514,0.34206,10,loser,winner
Mexico,Argentina,0,1,Friendly,United States,10,2,1999,-1,1,1,2533,1,1,Mexico,Argentina,9,1,0.22588,0.15905,10,loser,winner
Portugal,Netherlands,0,0,Friendly,France,10,2,1999,0,0,0,2534,1,1,Portugal,Netherlands,9,0,0.11444,0.11455,10,draw,draw
United States,Mexico,1,2,USA Cup,United States,13,3,1999,-1,1,3,2535,0,1,United_States,Mexico,9,1,0.3076,0.18886,10,loser,winner
England,Poland,3,1,UEFA Euro qualification,England,27,3,1999,2,-2,4,2536,1,0,England,Poland,9,2,0.40488,0.06373,10,winner,loser
South Korea,Brazil,1,0,Friendly,South Korea,28,3,1999,1,-1,1,2537,0,0,South_Korea,Brazil,9,1,0.02798,0.84206,10,winner,loser
Japan,Brazil,0,2,Friendly,Japan,31,3,1999,-2,2,2,2538,0,0,Japan,Brazil,9,2,0.1352,0.96564,10,loser,winner
Netherlands,Argentina,1,1,Friendly,Netherlands,31,3,1999,0,0,2,2539,1,1,Netherlands,Argentina,9,0,0.20007,0.61926,10,draw,draw
Switzerland,Wales,2,0,UEFA Euro qualification,Switzerland,31,3,1999,2,-2,2,2540,0,0,Switzerland,Wales,9,2,0.66927,0.96994,10,winner,loser
Mexico,Ecuador,0,0,Friendly,Mexico,14,4,1999,0,0,0,2541,1,0,Mexico,Ecuador,9,0,0.39886,0.68442,10,draw,draw
Netherlands,Morocco,1,2,Friendly,Netherlands,28,4,1999,-1,1,3,2542,1,0,Netherlands,Morocco,9,1,0.29001,0.58923,10,loser,winner
Spain,Croatia,3,1,Friendly,Spain,5,5,1999,2,-2,4,2543,1,0,Spain,Croatia,9,2,0.75885,0.60347,10,winner,loser
Ecuador,Iran,1,1,Friendly,Canada,2,6,1999,0,0,2,2544,0,1,Ecuador,Iran,9,0,0.20858,0.54647,10,draw,draw
Japan,Belgium,0,0,Kirin Cup,Japan,3,6,1999,0,0,0,2545,0,1,Japan,Belgium,9,0,0.33611,0.18482,10,draw,draw
Canada,Iran,0,1,Friendly,Canada,4,6,1999,-1,1,1,2546,0,1,Canada,Iran,9,1,0.66098,0.04444,10,loser,winner
Brazil,Netherlands,2,2,Friendly,Brazil,5,6,1999,0,0,4,2547,0,1,Brazil,Netherlands,9,0,0.86209,0.93786,10,draw,draw
South Korea,Belgium,1,2,Friendly,South Korea,5,6,1999,-1,1,3,2548,0,1,South_Korea,Belgium,9,1,0.91395,0.53215,10,loser,winner
Canada,Ecuador,1,2,Friendly,Canada,6,6,1999,-1,1,3,2549,0,0,Canada,Ecuador,9,1,0.90864,0.4986,10,loser,winner
Brazil,Netherlands,3,1,Friendly,Brazil,8,6,1999,2,-2,4,2550,0,1,Brazil,Netherlands,9,2,0.27508,0.31047,10,winner,loser
Mexico,Argentina,2,2,Friendly,United States,9,6,1999,0,0,4,2551,1,1,Mexico,Argentina,9,0,0.09233,0.10001,10,draw,draw
Wales,Denmark,0,2,UEFA Euro qualification,England,9,6,1999,-2,2,2,2552,0,1,Wales,Denmark,9,2,0.82567,0.06292,10,loser,winner
South Korea,Mexico,1,1,Korea Cup,South Korea,12,6,1999,0,0,2,2553,0,1,South_Korea,Mexico,9,0,0.05997,0.68972,10,draw,draw
United States,Argentina,1,0,Friendly,United States,13,6,1999,1,-1,1,2554,0,1,United_States,Argentina,9,1,0.63603,0.97921,10,winner,loser
Brazil,Poland,2,0,Friendly,Thailand,16,6,1999,2,-2,2,2555,0,0,Brazil,Poland,9,2,0.43192,0.32326,10,winner,loser
Croatia,Mexico,2,1,Korea Cup,South Korea,16,6,1999,1,-1,3,2556,0,1,Croatia,Mexico,9,1,0.1297,0.29824,10,winner,loser
South Korea,Croatia,1,1,Korea Cup,South Korea,19,6,1999,0,0,2,2557,0,0,South_Korea,Croatia,9,0,0.91631,0.19777,10,draw,draw
Argentina,Ecuador,3,1,Copa America,Paraguay,1,7,1999,2,-2,4,2558,1,0,Argentina,Ecuador,9,2,0.74322,0.54047,10,winner,loser
Brazil,Mexico,2,1,Copa America,Paraguay,3,7,1999,1,-1,3,2559,0,1,Brazil,Mexico,9,1,0.33552,0.96282,10,winner,loser
Uruguay,Ecuador,2,1,Copa America,Paraguay,4,7,1999,1,-1,3,2560,1,0,Uruguay,Ecuador,9,1,0.02944,0.40673,10,winner,loser
Uruguay,Argentina,0,2,Copa America,Paraguay,7,7,1999,-2,2,2,2561,1,1,Uruguay,Argentina,9,2,0.37302,0.74246,10,loser,winner
Canada,Saudi Arabia,0,2,Friendly,United States,9,7,1999,-2,2,2,2562,0,1,Canada,Saudi_Arabia,9,2,0.06867,0.84679,10,loser,winner
Brazil,Argentina,2,1,Copa America,Paraguay,11,7,1999,1,-1,3,2563,0,1,Brazil,Argentina,9,1,0.17406,0.46586,10,winner,loser
Mexico,Brazil,0,2,Copa America,Paraguay,14,7,1999,-2,2,2,2564,1,0,Mexico,Brazil,9,2,0.21223,0.77922,10,loser,winner
Costa Rica,Saudi Arabia,1,0,Friendly,United States,17,7,1999,1,-1,1,2565,1,1,Costa_Rica,Saudi_Arabia,9,1,0.005,0.90649,10,winner,loser
Brazil,Uruguay,3,0,Copa America,Paraguay,18,7,1999,3,-3,3,2566,0,1,Brazil,Uruguay,9,3,0.49716,0.46362,10,winner,loser
Brazil,Germany,4,0,Confederations Cup,Mexico,24,7,1999,4,-4,4,2567,0,1,Brazil,Germany,9,4,0.05627,0.45628,10,winner,loser
Mexico,Saudi Arabia,5,1,Confederations Cup,Mexico,25,7,1999,4,-4,6,2568,1,1,Mexico,Saudi_Arabia,9,4,0.26623,0.26613,10,winner,loser
Brazil,United States,1,0,Confederations Cup,Mexico,28,7,1999,1,-1,1,2569,0,0,Brazil,United_States,9,1,0.31363,0.74689,10,winner,loser
United States,Germany,2,0,Confederations Cup,Mexico,30,7,1999,2,-2,2,2570,0,1,United_States,Germany,9,2,0.46101,0.64323,10,winner,loser
Brazil,Saudi Arabia,8,2,Confederations Cup,Mexico,1,8,1999,6,-6,10,2571,0,1,Brazil,Saudi_Arabia,9,6,0.69757,0.21841,10,winner,loser
Mexico,United States,1,0,Confederations Cup,Mexico,1,8,1999,1,-1,1,2572,1,0,Mexico,United_States,9,1,0.95578,0.88752,10,winner,loser
United States,Saudi Arabia,2,0,Confederations Cup,Mexico,3,8,1999,2,-2,2,2573,0,1,United_States,Saudi_Arabia,9,2,0.38639,0.9295,10,winner,loser
Mexico,Brazil,4,3,Confederations Cup,Mexico,4,8,1999,1,-1,7,2574,1,0,Mexico,Brazil,9,1,0.21634,0.64302,10,winner,loser
Denmark,Netherlands,0,0,Friendly,Denmark,18,8,1999,0,0,0,2575,1,1,Denmark,Netherlands,9,0,0.23647,0.29082,10,draw,draw
Poland,Spain,1,2,Friendly,Poland,18,8,1999,-1,1,3,2576,0,1,Poland,Spain,9,1,0.31959,0.81992,10,loser,winner
Serbia,Croatia,0,0,UEFA Euro qualification,Yugoslavia,18,8,1999,0,0,0,2577,1,0,Serbia,Croatia,9,0,0.86227,0.45441,10,draw,draw
Uruguay,Costa Rica,5,4,Friendly,Uruguay,18,8,1999,1,-1,9,2578,1,1,Uruguay,Costa_Rica,9,1,0.12004,0.07388,10,winner,loser
Argentina,Brazil,2,0,Friendly,Argentina,4,9,1999,2,-2,2,2579,1,0,Argentina,Brazil,9,2,0.89056,0.14832,10,winner,loser
Denmark,Switzerland,2,1,UEFA Euro qualification,Denmark,4,9,1999,1,-1,3,2580,1,0,Denmark,Switzerland,9,1,0.36213,0.50185,10,winner,loser
Netherlands,Belgium,5,5,Friendly,Netherlands,4,9,1999,0,0,10,2581,1,1,Netherlands,Belgium,9,0,0.37085,0.4839,10,draw,draw
Belgium,Morocco,4,0,Friendly,Belgium,7,9,1999,4,-4,4,2582,1,0,Belgium,Morocco,9,4,0.68251,0.32193,10,winner,loser
Brazil,Argentina,4,2,Friendly,Brazil,7,9,1999,2,-2,6,2583,0,1,Brazil,Argentina,9,2,0.34984,0.83036,10,winner,loser
Japan,Iran,1,1,Friendly,Japan,8,9,1999,0,0,2,2584,0,1,Japan,Iran,9,0,0.31687,0.76036,10,draw,draw
Poland,England,0,0,UEFA Euro qualification,Poland,8,9,1999,0,0,0,2585,0,1,Poland,England,9,0,0.93019,0.76572,10,draw,draw
Croatia,Serbia,2,2,UEFA Euro qualification,Croatia,9,10,1999,0,0,4,2586,0,1,Croatia,Serbia,9,0,0.89728,0.37963,10,draw,draw
Netherlands,Brazil,2,2,Friendly,Netherlands,9,10,1999,0,0,4,2587,1,0,Netherlands,Brazil,9,0,0.31649,0.29122,10,draw,draw
Wales,Switzerland,0,2,UEFA Euro qualification,Wales,9,10,1999,-2,2,2,2588,0,0,Wales,Switzerland,9,2,0.09009,0.27323,10,loser,winner
Denmark,Iran,0,0,Friendly,Denmark,10,10,1999,0,0,0,2589,1,1,Denmark,Iran,9,0,0.55839,0.09365,10,draw,draw
England,Belgium,2,1,Friendly,England,10,10,1999,1,-1,3,2590,1,1,England,Belgium,9,1,0.28048,0.08954,10,winner,loser
Uruguay,Ecuador,0,0,Friendly,Uruguay,12,10,1999,0,0,0,2591,1,0,Uruguay,Ecuador,9,0,0.21883,0.90533,10,draw,draw
Mexico,Ecuador,0,0,Friendly,United States,27,10,1999,0,0,0,2592,1,0,Mexico,Ecuador,9,0,0.41947,0.36462,10,draw,draw
France,Croatia,3,0,Friendly,France,13,11,1999,3,-3,3,2593,0,0,France,Croatia,9,3,0.25714,0.23407,10,winner,loser
Spain,Brazil,0,0,Friendly,Spain,13,11,1999,0,0,0,2594,1,0,Spain,Brazil,9,0,0.55549,0.01709,10,draw,draw
Morocco,United States,2,1,Friendly,Morocco,17,11,1999,1,-1,3,2595,0,0,Morocco,United_States,9,1,0.24753,0.92876,10,winner,loser
Spain,Argentina,0,2,Friendly,Spain,17,11,1999,-2,2,2,2596,1,1,Spain,Argentina,9,2,0.23207,0.00708,10,loser,winner
Morocco,Senegal,0,0,Friendly,Morocco,21,12,1999,0,0,0,2597,0,0,Morocco,Senegal,9,0,0.46726,0.37127,10,draw,draw
Tunisia,Ghana,2,0,Friendly,Tunisia,22,12,1999,2,-2,2,2598,1,0,Tunisia,Ghana,9,2,0.9302,0.64379,10,winner,loser
Mexico,Iran,2,1,Friendly,United States,9,1,2000,1,-1,3,2599,1,1,Mexico,Iran,0,1,0.82998,0.69309,11,winner,loser
Senegal,Cameroon,0,0,Friendly,Senegal,13,1,2000,0,0,0,2600,0,1,Senegal,Cameroon,0,0,0.95822,0.43214,11,draw,draw
United States,Iran,1,1,Friendly,United States,16,1,2000,0,0,2,2601,0,1,United_States,Iran,0,0,0.77117,0.81687,11,draw,draw
Ghana,Tunisia,2,0,Friendly,Ghana,18,1,2000,2,-2,2,2602,0,1,Ghana,Tunisia,0,2,0.05928,0.7584,11,winner,loser
Ghana,Cameroon,1,1,African Cup of Nations,Ghana,22,1,2000,0,0,2,2603,0,1,Ghana,Cameroon,0,0,0.25772,0.27557,11,draw,draw
Spain,Poland,3,0,Friendly,Spain,26,1,2000,3,-3,3,2604,1,0,Spain,Poland,0,3,0.87429,0.94772,11,winner,loser
Tunisia,Morocco,0,0,African Cup of Nations,Nigeria,29,1,2000,0,0,0,2605,1,0,Tunisia,Morocco,0,0,0.56368,0.93104,11,draw,draw
Japan,Mexico,0,1,Lunar New Year Cup,Hong Kong,5,2,2000,-1,1,1,2606,0,1,Japan,Mexico,0,1,0.59066,0.24623,11,loser,winner
Cameroon,Tunisia,3,0,African Cup of Nations,Ghana,10,2,2000,3,-3,3,2607,1,1,Cameroon,Tunisia,0,3,0.9177,0.32005,11,winner,loser
Costa Rica,Canada,2,2,Gold Cup,United States,13,2,2000,0,0,4,2608,1,0,Costa_Rica,Canada,0,0,0.77101,0.00635,11,draw,draw
Canada,South Korea,0,0,Gold Cup,United States,15,2,2000,0,0,0,2609,0,0,Canada,South_Korea,0,0,0.23037,0.6948,11,draw,draw
South Korea,Costa Rica,2,2,Gold Cup,United States,17,2,2000,0,0,4,2610,0,1,South_Korea,Costa_Rica,0,0,0.09895,0.72005,11,draw,draw
Mexico,Canada,1,2,Gold Cup,United States,20,2,2000,-1,1,3,2611,1,0,Mexico,Canada,0,1,0.03706,0.07448,11,loser,winner
Belgium,Portugal,1,1,Friendly,Belgium,23,2,2000,0,0,2,2612,1,1,Belgium,Portugal,0,0,0.1956,0.84592,11,draw,draw
Croatia,Spain,0,0,Friendly,Croatia,23,2,2000,0,0,0,2613,0,1,Croatia,Spain,0,0,0.73508,0.5758,11,draw,draw
England,Argentina,0,0,Friendly,England,23,2,2000,0,0,0,2614,1,1,England,Argentina,0,0,0.42752,0.95374,11,draw,draw
France,Poland,1,0,Friendly,France,23,2,2000,1,-1,1,2615,0,0,France,Poland,0,1,0.98842,0.75392,11,winner,loser
Netherlands,Germany,2,1,Friendly,Netherlands,23,2,2000,1,-1,3,2616,1,1,Netherlands,Germany,0,1,0.97545,0.64588,11,winner,loser
Qatar,Wales,0,1,Friendly,Qatar,23,2,2000,-1,1,1,2617,0,0,Qatar,Wales,0,1,0.11831,0.02655,11,loser,winner
United States,Tunisia,1,1,Friendly,United States,12,3,2000,0,0,2,2618,0,1,United_States,Tunisia,0,0,0.55251,0.43448,11,draw,draw
Belgium,Netherlands,2,2,Friendly,Belgium,29,3,2000,0,0,4,2619,1,1,Belgium,Netherlands,0,0,0.79813,0.47645,11,draw,draw
Croatia,Germany,1,1,Friendly,Croatia,29,3,2000,0,0,2,2620,0,1,Croatia,Germany,0,0,0.26336,0.67074,11,draw,draw
Portugal,Denmark,2,1,Friendly,Portugal,29,3,2000,1,-1,3,2621,1,1,Portugal,Denmark,0,1,0.65848,0.97582,11,winner,loser
Brazil,Ecuador,3,2,FIFA World Cup qualification,Brazil,26,4,2000,1,-1,5,2622,0,0,Brazil,Ecuador,0,1,0.16407,0.97671,11,winner,loser
Germany,Switzerland,1,1,Friendly,Germany,26,4,2000,0,0,2,2623,1,0,Germany,Switzerland,0,0,0.80898,0.16428,11,draw,draw
South Korea,Japan,1,0,Friendly,South Korea,26,4,2000,1,-1,1,2624,0,0,South_Korea,Japan,0,1,0.47037,0.03605,11,winner,loser
Wales,Brazil,0,3,Friendly,Wales,23,5,2000,-3,3,3,2625,0,0,Wales,Brazil,0,3,0.61706,0.77013,11,loser,winner
England,Brazil,1,1,Friendly,England,27,5,2000,0,0,2,2626,1,0,England,Brazil,0,0,0.65595,0.58671,11,draw,draw
Croatia,France,0,2,Friendly,Croatia,28,5,2000,-2,2,2,2627,0,0,Croatia,France,0,2,0.35648,0.74399,11,loser,winner
South Korea,Serbia,0,0,Friendly,South Korea,28,5,2000,0,0,0,2628,0,1,South_Korea,Serbia,0,0,0.65522,0.57286,11,draw,draw
South Korea,Serbia,0,0,Friendly,South Korea,30,5,2000,0,0,0,2629,0,1,South_Korea,Serbia,0,0,0.14318,0.45386,11,draw,draw
Portugal,Wales,3,0,Friendly,Portugal,2,6,2000,3,-3,3,2630,1,0,Portugal,Wales,0,3,0.85724,0.14125,11,winner,loser
Denmark,Belgium,2,2,Friendly,Denmark,3,6,2000,0,0,4,2631,1,1,Denmark,Belgium,0,0,0.35867,0.45288,11,draw,draw
France,Japan,2,2,King Hassan II Tournament,Morocco,4,6,2000,0,0,4,2632,0,0,France,Japan,0,0,0.04725,0.70065,11,draw,draw
Netherlands,Poland,3,1,Friendly,Switzerland,4,6,2000,2,-2,4,2633,1,0,Netherlands,Poland,0,2,0.64758,0.28602,11,winner,loser
Morocco,France,1,5,King Hassan II Tournament,Morocco,6,6,2000,-4,4,6,2634,0,0,Morocco,France,0,4,0.9242,0.95871,11,loser,winner
France,Denmark,3,0,UEFA Euro,Belgium,11,6,2000,3,-3,3,2635,0,1,France,Denmark,0,3,0.57066,0.72409,11,winner,loser
Tunisia,Senegal,4,1,Friendly,Tunisia,11,6,2000,3,-3,5,2636,1,0,Tunisia,Senegal,0,3,0.15817,0.21581,11,winner,loser
United States,Mexico,3,0,USA Cup,United States,11,6,2000,3,-3,3,2637,0,1,United_States,Mexico,0,3,0.73259,0.81865,11,winner,loser
Portugal,England,3,2,UEFA Euro,Netherlands,12,6,2000,1,-1,5,2638,1,1,Portugal,England,0,1,0.85018,0.04388,11,winner,loser
Netherlands,Denmark,3,0,UEFA Euro,Netherlands,16,6,2000,3,-3,3,2639,1,1,Netherlands,Denmark,0,3,0.40193,0.39519,11,winner,loser
England,Germany,1,0,UEFA Euro,Belgium,17,6,2000,1,-1,1,2640,1,1,England,Germany,0,1,0.95777,0.24558,11,winner,loser
Portugal,Germany,3,0,UEFA Euro,Netherlands,20,6,2000,3,-3,3,2641,1,1,Portugal,Germany,0,3,0.27015,0.32568,11,winner,loser
Netherlands,France,3,2,UEFA Euro,Netherlands,21,6,2000,1,-1,5,2642,1,0,Netherlands,France,0,1,0.25507,0.13621,11,winner,loser
Serbia,Spain,3,4,UEFA Euro,Belgium,21,6,2000,-1,1,7,2643,1,1,Serbia,Spain,0,1,0.39882,0.39126,11,loser,winner
Netherlands,Serbia,6,1,UEFA Euro,Netherlands,25,6,2000,5,-5,7,2644,1,1,Netherlands,Serbia,0,5,0.23363,0.22134,11,winner,loser
Spain,France,1,2,UEFA Euro,Belgium,25,6,2000,-1,1,3,2645,1,0,Spain,France,0,1,0.61201,0.12698,11,loser,winner
Brazil,Uruguay,1,1,FIFA World Cup qualification,Brazil,28,6,2000,0,0,2,2646,0,1,Brazil,Uruguay,0,0,0.72663,0.88836,11,draw,draw
France,Portugal,2,1,UEFA Euro,Belgium,28,6,2000,1,-1,3,2647,0,1,France,Portugal,0,1,0.47916,0.29204,11,winner,loser
Argentina,Ecuador,2,0,FIFA World Cup qualification,Argentina,19,7,2000,2,-2,2,2648,1,0,Argentina,Ecuador,0,2,0.63234,0.18628,11,winner,loser
Costa Rica,United States,2,1,FIFA World Cup qualification,Costa Rica,23,7,2000,1,-1,3,2649,1,0,Costa_Rica,United_States,0,1,0.89459,0.90255,11,winner,loser
Brazil,Argentina,3,1,FIFA World Cup qualification,Brazil,26,7,2000,2,-2,4,2650,0,1,Brazil,Argentina,0,2,0.61809,0.01273,11,winner,loser
Mexico,Canada,2,0,FIFA World Cup qualification,Mexico,15,8,2000,2,-2,2,2651,1,0,Mexico,Canada,0,2,0.52227,0.61891,11,winner,loser
Germany,Spain,4,1,Friendly,Germany,16,8,2000,3,-3,5,2652,1,1,Germany,Spain,0,3,0.03724,0.60822,11,winner,loser
Belgium,Croatia,0,0,FIFA World Cup qualification,Belgium,2,9,2000,0,0,0,2653,1,0,Belgium,Croatia,0,0,0.21252,0.01159,11,draw,draw
France,England,1,1,Friendly,France,2,9,2000,0,0,2,2654,0,1,France,England,0,0,0.94815,0.37387,11,draw,draw
Uruguay,Ecuador,4,0,FIFA World Cup qualification,Uruguay,3,9,2000,4,-4,4,2655,1,0,Uruguay,Ecuador,0,4,0.43977,0.27407,11,winner,loser
Mexico,Ecuador,2,0,Friendly,United States,20,9,2000,2,-2,2,2656,1,0,Mexico,Ecuador,0,2,0.50761,0.99618,11,winner,loser
Qatar,Iran,1,2,Friendly,Qatar,27,9,2000,-1,1,3,2657,0,1,Qatar,Iran,0,1,0.68901,0.32823,11,loser,winner
France,Cameroon,1,1,Friendly,France,4,10,2000,0,0,2,2658,0,1,France,Cameroon,0,0,0.72974,0.14273,11,draw,draw
Australia,South Korea,2,4,United Arab Emirates Friendship Tournament,United Arab Emirates,7,10,2000,-2,2,6,2659,0,0,Australia,South_Korea,0,2,0.33195,0.69949,11,loser,winner
England,Germany,0,1,FIFA World Cup qualification,England,7,10,2000,-1,1,1,2660,1,1,England,Germany,0,1,0.78913,0.41569,11,loser,winner
Argentina,Uruguay,2,1,FIFA World Cup qualification,Argentina,8,10,2000,1,-1,3,2661,1,1,Argentina,Uruguay,0,1,0.24161,0.33572,11,winner,loser
Netherlands,Portugal,0,2,FIFA World Cup qualification,Netherlands,11,10,2000,-2,2,2,2662,1,1,Netherlands,Portugal,0,2,0.92115,0.14944,11,loser,winner
Poland,Wales,0,0,FIFA World Cup qualification,Poland,11,10,2000,0,0,0,2663,0,0,Poland,Wales,0,0,0.35229,0.4874,11,draw,draw
United States,Costa Rica,0,0,FIFA World Cup qualification,United States,11,10,2000,0,0,0,2664,0,1,United_States,Costa_Rica,0,0,0.12292,0.2996,11,draw,draw
Saudi Arabia,Japan,1,4,AFC Asian Cup,Lebanon,14,10,2000,-3,3,5,2665,1,0,Saudi_Arabia,Japan,0,3,0.55433,0.95155,11,loser,winner
Saudi Arabia,Qatar,0,0,AFC Asian Cup,Lebanon,17,10,2000,0,0,0,2666,1,0,Saudi_Arabia,Qatar,0,0,0.18883,0.62401,11,draw,draw
Japan,Qatar,1,1,AFC Asian Cup,Lebanon,20,10,2000,0,0,2,2667,0,0,Japan,Qatar,0,0,0.20327,0.14662,11,draw,draw
Iran,South Korea,1,2,AFC Asian Cup,Lebanon,23,10,2000,-1,1,3,2668,1,0,Iran,South_Korea,0,1,0.14231,0.33025,11,loser,winner
United States,Mexico,2,0,Friendly,United States,25,10,2000,2,-2,2,2669,0,1,United_States,Mexico,0,2,0.03634,0.95482,11,winner,loser
South Korea,Saudi Arabia,1,2,AFC Asian Cup,Lebanon,26,10,2000,-1,1,3,2670,0,1,South_Korea,Saudi_Arabia,0,1,0.53845,0.22841,11,loser,winner
Japan,Saudi Arabia,1,0,AFC Asian Cup,Lebanon,29,10,2000,1,-1,1,2671,0,1,Japan,Saudi_Arabia,0,1,0.32081,0.9108,11,winner,loser
Canada,Mexico,0,0,FIFA World Cup qualification,Canada,15,11,2000,0,0,0,2672,0,1,Canada,Mexico,0,0,0.26272,0.83104,11,draw,draw
Denmark,Germany,2,1,Friendly,Denmark,15,11,2000,1,-1,3,2673,1,1,Denmark,Germany,0,1,0.14224,0.08591,11,winner,loser
Spain,Netherlands,1,2,Friendly,Spain,15,11,2000,-1,1,3,2674,1,1,Spain,Netherlands,0,1,0.70234,0.1886,11,loser,winner
Tunisia,Switzerland,1,1,Friendly,Tunisia,15,11,2000,0,0,2,2675,1,0,Tunisia,Switzerland,0,0,0.35897,0.16569,11,draw,draw
Japan,South Korea,1,1,Friendly,Japan,20,12,2000,0,0,2,2676,0,0,Japan,South_Korea,0,0,0.80081,0.95113,11,draw,draw
Mexico,Argentina,0,2,Friendly,United States,20,12,2000,-2,2,2,2677,1,1,Mexico,Argentina,0,2,0.73126,0.84209,11,loser,winner
Tunisia,Morocco,0,1,African Cup of Nations qualification,Tunisia,13,1,2001,-1,1,1,2678,1,0,Tunisia,Morocco,1,1,0.57216,0.49181,11,loser,winner
Serbia,Japan,1,0,Millennium Cup,India,23,1,2001,1,-1,1,2679,1,0,Serbia,Japan,1,1,0.12952,0.84291,11,winner,loser
Morocco,South Korea,1,1,United Arab Emirates Friendship Tournament,United Arab Emirates,8,2,2001,0,0,2,2680,0,0,Morocco,South_Korea,1,0,0.08725,0.25095,11,draw,draw
Morocco,Senegal,0,0,FIFA World Cup qualification,Morocco,24,2,2001,0,0,0,2681,0,0,Morocco,Senegal,1,0,0.89233,0.40402,11,draw,draw
France,Germany,1,0,Friendly,France,27,2,2001,1,-1,1,2682,0,1,France,Germany,1,1,0.53823,0.84672,11,winner,loser
England,Spain,3,0,Friendly,England,28,2,2001,3,-3,3,2683,1,1,England,Spain,1,3,0.79923,0.32273,11,winner,loser
Switzerland,Poland,0,4,Friendly,Cyprus,28,2,2001,-4,4,4,2684,0,0,Switzerland,Poland,1,4,0.2978,0.05333,11,loser,winner
United States,Mexico,2,0,FIFA World Cup qualification,United States,28,2,2001,2,-2,2,2685,0,1,United_States,Mexico,1,2,0.41087,0.47901,11,winner,loser
United States,Brazil,1,2,Friendly,United States,3,3,2001,-1,1,3,2686,0,0,United_States,Brazil,1,1,0.27988,0.62776,11,loser,winner
Mexico,Brazil,3,3,Friendly,Mexico,7,3,2001,0,0,6,2687,1,0,Mexico,Brazil,1,0,0.95666,0.30696,11,draw,draw
France,Japan,5,0,Friendly,France,24,3,2001,5,-5,5,2688,0,0,France,Japan,1,5,0.58331,0.18319,11,winner,loser
Morocco,Tunisia,2,0,African Cup of Nations qualification,Morocco,24,3,2001,2,-2,2,2689,0,1,Morocco,Tunisia,1,2,0.90878,0.36793,11,winner,loser
Serbia,Switzerland,1,1,FIFA World Cup qualification,Yugoslavia,24,3,2001,0,0,2,2690,1,0,Serbia,Switzerland,1,0,0.40638,0.60091,11,draw,draw
Ecuador,Brazil,1,0,FIFA World Cup qualification,Ecuador,28,3,2001,1,-1,1,2691,0,0,Ecuador,Brazil,1,1,0.66603,0.0505,11,winner,loser
Portugal,Netherlands,2,2,FIFA World Cup qualification,Portugal,28,3,2001,0,0,4,2692,1,1,Portugal,Netherlands,1,0,0.59751,0.79501,11,draw,draw
Spain,France,2,1,Friendly,Spain,28,3,2001,1,-1,3,2693,1,0,Spain,France,1,1,0.61489,0.5077,11,winner,loser
Iran,South Korea,0,1,Friendly,Egypt,24,4,2001,-1,1,1,2694,1,0,Iran,South_Korea,1,1,0.95706,0.37081,11,loser,winner
France,Portugal,4,0,Friendly,France,25,4,2001,4,-4,4,2695,0,1,France,Portugal,1,4,0.56808,0.85184,11,winner,loser
Spain,Japan,1,0,Friendly,Spain,25,4,2001,1,-1,1,2696,1,0,Spain,Japan,1,1,0.98138,0.11111,11,winner,loser
United States,Costa Rica,1,0,FIFA World Cup qualification,United States,25,4,2001,1,-1,1,2697,0,1,United_States,Costa_Rica,1,1,0.32487,0.43699,11,winner,loser
Canada,Iran,1,0,Friendly,Egypt,26,4,2001,1,-1,1,2698,0,1,Canada,Iran,1,1,0.72411,0.09328,11,winner,loser
England,Mexico,4,0,Friendly,England,25,5,2001,4,-4,4,2699,1,1,England,Mexico,1,4,0.23523,0.12211,11,winner,loser
South Korea,Cameroon,0,0,Friendly,South Korea,25,5,2001,0,0,0,2700,0,1,South_Korea,Cameroon,1,0,0.58466,0.51302,11,draw,draw
South Korea,France,0,5,Confederations Cup,South Korea,30,5,2001,-5,5,5,2701,0,0,South_Korea,France,1,5,0.9683,0.63832,11,loser,winner
Mexico,Australia,0,2,Confederations Cup,South Korea,30,5,2001,-2,2,2,2702,1,0,Mexico,Australia,1,2,0.50812,0.26141,11,loser,winner
Brazil,Cameroon,2,0,Confederations Cup,Japan,31,5,2001,2,-2,2,2703,0,1,Brazil,Cameroon,1,2,0.44984,0.22179,11,winner,loser
Japan,Canada,3,0,Confederations Cup,Japan,31,5,2001,3,-3,3,2704,0,0,Japan,Canada,1,3,0.62887,0.05096,11,winner,loser
Australia,France,1,0,Confederations Cup,South Korea,1,6,2001,1,-1,1,2705,0,0,Australia,France,1,1,0.60366,0.12471,11,winner,loser
South Korea,Mexico,2,1,Confederations Cup,South Korea,1,6,2001,1,-1,3,2706,0,1,South_Korea,Mexico,1,1,0.93574,0.11349,11,winner,loser
Canada,Brazil,0,0,Confederations Cup,Japan,2,6,2001,0,0,0,2707,0,0,Canada,Brazil,1,0,0.41923,0.38475,11,draw,draw
Japan,Cameroon,2,0,Confederations Cup,Japan,2,6,2001,2,-2,2,2708,0,1,Japan,Cameroon,1,2,0.5037,0.87641,11,winner,loser
Wales,Poland,1,2,FIFA World Cup qualification,Wales,2,6,2001,-1,1,3,2709,0,0,Wales,Poland,1,1,0.74357,0.46161,11,loser,winner
France,Mexico,4,0,Confederations Cup,South Korea,3,6,2001,4,-4,4,2710,0,1,France,Mexico,1,4,0.95033,0.41888,11,winner,loser
South Korea,Australia,1,0,Confederations Cup,South Korea,3,6,2001,1,-1,1,2711,0,0,South_Korea,Australia,1,1,0.16211,0.29406,11,winner,loser
Cameroon,Canada,2,0,Confederations Cup,Japan,4,6,2001,2,-2,2,2712,1,0,Cameroon,Canada,1,2,0.26054,0.2295,11,winner,loser
Japan,Brazil,0,0,Confederations Cup,Japan,4,6,2001,0,0,0,2713,0,0,Japan,Brazil,1,0,0.7472,0.84426,11,draw,draw
France,Brazil,2,1,Confederations Cup,South Korea,7,6,2001,1,-1,3,2714,0,0,France,Brazil,1,1,0.93838,0.50012,11,winner,loser
Japan,Australia,1,0,Confederations Cup,Japan,7,6,2001,1,-1,1,2715,0,0,Japan,Australia,1,1,0.68322,0.01794,11,winner,loser
United States,Ecuador,0,0,Friendly,United States,7,6,2001,0,0,0,2716,0,0,United_States,Ecuador,1,0,0.42274,0.90374,11,draw,draw
Australia,Brazil,1,0,Confederations Cup,South Korea,9,6,2001,1,-1,1,2717,0,0,Australia,Brazil,1,1,0.82668,0.18874,11,winner,loser
Japan,France,0,1,Confederations Cup,Japan,10,6,2001,-1,1,1,2718,0,0,Japan,France,1,1,0.92644,0.3273,11,loser,winner
Mexico,Costa Rica,1,2,FIFA World Cup qualification,Mexico,16,6,2001,-1,1,3,2719,1,1,Mexico,Costa_Rica,1,1,0.03661,0.34822,11,loser,winner
Mexico,United States,1,0,FIFA World Cup qualification,Mexico,1,7,2001,1,-1,1,2720,1,0,Mexico,United_States,1,1,0.00479,0.66837,11,winner,loser
Uruguay,Brazil,1,0,FIFA World Cup qualification,Uruguay,1,7,2001,1,-1,1,2721,1,0,Uruguay,Brazil,1,1,0.80481,0.70037,11,winner,loser
Japan,Serbia,1,0,Kirin Cup,Japan,4,7,2001,1,-1,1,2722,0,1,Japan,Serbia,1,1,0.35687,0.49312,11,winner,loser
Brazil,Mexico,0,1,Copa America,Colombia,12,7,2001,-1,1,1,2723,0,1,Brazil,Mexico,1,1,0.11369,0.89595,11,loser,winner
Senegal,Morocco,1,0,FIFA World Cup qualification,Senegal,14,7,2001,1,-1,1,2724,0,0,Senegal,Morocco,1,1,0.20797,0.00147,11,winner,loser
Uruguay,Costa Rica,1,1,Copa America,Colombia,16,7,2001,0,0,2,2725,1,1,Uruguay,Costa_Rica,1,0,0.82047,0.14347,11,draw,draw
Uruguay,Costa Rica,2,1,Copa America,Colombia,22,7,2001,1,-1,3,2726,1,1,Uruguay,Costa_Rica,1,1,0.97925,0.23127,11,winner,loser
Mexico,Uruguay,2,1,Copa America,Colombia,25,7,2001,1,-1,3,2727,1,1,Mexico,Uruguay,1,1,0.27716,0.97327,11,winner,loser
Qatar,Iran,2,1,Friendly,Qatar,1,8,2001,1,-1,3,2728,0,1,Qatar,Iran,1,1,0.78945,0.68412,11,winner,loser
Saudi Arabia,Qatar,1,2,Friendly,Saudi Arabia,5,8,2001,-1,1,3,2729,1,0,Saudi_Arabia,Qatar,1,1,0.13967,0.13759,11,loser,winner
Ecuador,Argentina,0,2,FIFA World Cup qualification,Ecuador,15,8,2001,-2,2,2,2730,0,1,Ecuador,Argentina,1,2,0.32574,0.06263,11,loser,winner
England,Netherlands,0,2,Friendly,England,15,8,2001,-2,2,2,2731,1,1,England,Netherlands,1,2,0.09226,0.75029,11,loser,winner
France,Denmark,1,0,Friendly,France,15,8,2001,1,-1,1,2732,0,1,France,Denmark,1,1,0.71485,0.22737,11,winner,loser
Japan,Australia,3,0,Friendly,Japan,15,8,2001,3,-3,3,2733,0,0,Japan,Australia,1,3,0.6433,0.44266,11,winner,loser
Iran,Saudi Arabia,2,0,FIFA World Cup qualification,Iran,24,8,2001,2,-2,2,2734,1,1,Iran,Saudi_Arabia,1,2,0.37813,0.13426,11,winner,loser
Germany,England,1,5,FIFA World Cup qualification,Germany,1,9,2001,-4,4,6,2735,1,1,Germany,England,1,4,0.45453,0.0366,11,loser,winner
Switzerland,Serbia,1,2,FIFA World Cup qualification,Switzerland,1,9,2001,-1,1,3,2736,0,1,Switzerland,Serbia,1,1,0.05911,0.89902,11,loser,winner
Argentina,Brazil,2,1,FIFA World Cup qualification,Argentina,5,9,2001,1,-1,3,2737,1,0,Argentina,Brazil,1,1,0.86214,0.02031,11,winner,loser
Costa Rica,United States,2,0,FIFA World Cup qualification,Costa Rica,5,9,2001,2,-2,2,2738,1,0,Costa_Rica,United_States,1,2,0.56797,0.2217,11,winner,loser
Saudi Arabia,Iran,2,2,FIFA World Cup qualification,Saudi Arabia,28,9,2001,0,0,4,2739,1,1,Saudi_Arabia,Iran,1,0,0.28769,0.1414,11,draw,draw
Japan,Senegal,0,2,Friendly,France,4,10,2001,-2,2,2,2740,0,0,Japan,Senegal,1,2,0.63477,0.97648,11,loser,winner
Croatia,Belgium,1,0,FIFA World Cup qualification,Croatia,6,10,2001,1,-1,1,2741,0,1,Croatia,Belgium,1,1,0.73316,0.34863,11,winner,loser
Costa Rica,Mexico,0,0,FIFA World Cup qualification,Costa Rica,7,10,2001,0,0,0,2742,1,1,Costa_Rica,Mexico,1,0,0.99384,0.74869,11,draw,draw
Ecuador,Uruguay,1,1,FIFA World Cup qualification,Ecuador,7,11,2001,0,0,2,2743,0,1,Ecuador,Uruguay,1,0,0.47425,0.77077,11,draw,draw
South Korea,Senegal,0,1,Friendly,South Korea,8,11,2001,-1,1,1,2744,0,0,South_Korea,Senegal,1,1,0.83632,0.35198,11,loser,winner
Denmark,Netherlands,1,1,Friendly,Denmark,10,11,2001,0,0,2,2745,1,1,Denmark,Netherlands,1,0,0.16427,0.50308,11,draw,draw
South Korea,Croatia,2,0,Friendly,South Korea,10,11,2001,2,-2,2,2746,0,0,South_Korea,Croatia,1,2,0.85824,0.69125,11,winner,loser
Australia,France,1,1,Friendly,Australia,11,11,2001,0,0,2,2747,0,0,Australia,France,1,0,0.66242,0.8506,11,draw,draw
South Korea,Croatia,1,1,Friendly,South Korea,13,11,2001,0,0,2,2748,0,0,South_Korea,Croatia,1,0,0.68287,0.88998,11,draw,draw
Poland,Cameroon,0,0,Friendly,Poland,14,11,2001,0,0,0,2749,0,1,Poland,Cameroon,1,0,0.61222,0.04559,11,draw,draw
Spain,Mexico,1,0,Friendly,Spain,14,11,2001,1,-1,1,2750,1,1,Spain,Mexico,1,1,0.49415,0.05516,11,winner,loser
Uruguay,Argentina,1,1,FIFA World Cup qualification,Uruguay,14,11,2001,0,0,2,2751,1,1,Uruguay,Argentina,1,0,0.10764,0.43825,11,draw,draw
Australia,Uruguay,1,0,FIFA World Cup qualification,Australia,20,11,2001,1,-1,1,2752,0,1,Australia,Uruguay,1,1,0.46985,0.56149,11,winner,loser
Uruguay,Australia,3,0,FIFA World Cup qualification,Uruguay,25,11,2001,3,-3,3,2753,1,0,Uruguay,Australia,1,3,0.97939,0.41569,11,winner,loser
South Korea,United States,1,0,Friendly,South Korea,9,12,2001,1,-1,1,2754,0,0,South_Korea,United_States,1,1,0.35572,0.57408,11,winner,loser
Tunisia,Cameroon,0,1,Friendly,Tunisia,11,1,2002,-1,1,1,2755,1,1,Tunisia,Cameroon,2,1,0.12718,0.18594,11,loser,winner
United States,South Korea,2,1,Gold Cup,United States,19,1,2002,1,-1,3,2756,0,0,United_States,South_Korea,2,1,0.44114,0.3859,11,winner,loser
Morocco,Ghana,0,0,African Cup of Nations,Mali,21,1,2002,0,0,0,2757,0,0,Morocco,Ghana,2,0,0.19574,0.80982,11,draw,draw
Canada,Ecuador,0,2,Gold Cup,United States,22,1,2002,-2,2,2,2758,0,0,Canada,Ecuador,2,2,0.74961,0.57557,11,loser,winner
Mexico,South Korea,0,0,Gold Cup,United States,27,1,2002,0,0,0,2759,1,0,Mexico,South_Korea,2,0,0.97332,0.33038,11,draw,draw
Costa Rica,South Korea,3,1,Gold Cup,United States,30,1,2002,2,-2,4,2760,1,0,Costa_Rica,South_Korea,2,2,0.64717,0.56699,11,winner,loser
United States,Canada,0,0,Gold Cup,United States,30,1,2002,0,0,0,2761,0,0,United_States,Canada,2,0,0.46479,0.60562,11,draw,draw
Saudi Arabia,Qatar,3,1,Gulf Cup,Saudi Arabia,30,1,2002,2,-2,4,2762,1,0,Saudi_Arabia,Qatar,2,2,0.07011,0.5541,11,winner,loser
Senegal,Tunisia,0,0,African Cup of Nations,Mali,31,1,2002,0,0,0,2763,0,1,Senegal,Tunisia,2,0,0.96339,0.1049,11,draw,draw
Canada,South Korea,2,1,Gold Cup,United States,2,2,2002,1,-1,3,2764,0,0,Canada,South_Korea,2,1,0.95099,0.95578,11,winner,loser
United States,Costa Rica,2,0,Gold Cup,United States,2,2,2002,2,-2,2,2765,0,1,United_States,Costa_Rica,2,2,0.7972,0.50272,11,winner,loser
Saudi Arabia,Brazil,0,1,Friendly,Saudi Arabia,6,2,2002,-1,1,1,2766,1,0,Saudi_Arabia,Brazil,2,1,0.07418,0.77673,11,loser,winner
Senegal,Cameroon,0,0,African Cup of Nations,Mali,10,2,2002,0,0,0,2767,0,1,Senegal,Cameroon,2,0,0.16059,0.31167,11,draw,draw
Mexico,Serbia,1,2,Friendly,United States,13,2,2002,-1,1,3,2768,1,1,Mexico,Serbia,2,1,0.93419,0.23444,11,loser,winner
Netherlands,England,1,1,Friendly,Netherlands,13,2,2002,0,0,2,2769,1,1,Netherlands,England,2,0,0.29034,0.49563,11,draw,draw
Saudi Arabia,Denmark,0,1,Friendly,Saudi Arabia,13,2,2002,-1,1,1,2770,1,1,Saudi_Arabia,Denmark,2,1,0.80313,0.89602,11,loser,winner
Spain,Portugal,1,1,Friendly,Spain,13,2,2002,0,0,2,2771,1,1,Spain,Portugal,2,0,0.89013,0.07834,11,draw,draw
Uruguay,South Korea,2,1,Friendly,Uruguay,13,2,2002,1,-1,3,2772,1,0,Uruguay,South_Korea,2,1,0.61138,0.79146,11,winner,loser
Wales,Argentina,1,1,Friendly,Wales,13,2,2002,0,0,2,2773,0,1,Wales,Argentina,2,0,0.82011,0.10152,11,draw,draw
United States,Ecuador,1,0,Friendly,United States,10,3,2002,1,-1,1,2774,0,0,United_States,Ecuador,2,1,0.1991,0.30154,11,winner,loser
Tunisia,South Korea,0,0,Friendly,Tunisia,13,3,2002,0,0,0,2775,1,0,Tunisia,South_Korea,2,0,0.04771,0.14436,11,draw,draw
Argentina,Cameroon,2,2,Friendly,Switzerland,27,3,2002,0,0,4,2776,1,1,Argentina,Cameroon,2,0,0.87942,0.03241,11,draw,draw
Brazil,Serbia,1,0,Friendly,Brazil,27,3,2002,1,-1,1,2777,0,1,Brazil,Serbia,2,1,0.20296,0.66744,11,winner,loser
Germany,United States,4,2,Friendly,Germany,27,3,2002,2,-2,6,2778,1,0,Germany,United_States,2,2,0.93682,0.91427,11,winner,loser
Netherlands,Spain,1,0,Friendly,Netherlands,27,3,2002,1,-1,1,2779,1,1,Netherlands,Spain,2,1,0.22049,0.80678,11,winner,loser
Poland,Japan,0,2,Friendly,Poland,27,3,2002,-2,2,2,2780,0,0,Poland,Japan,2,2,0.76545,0.66598,11,loser,winner
Saudi Arabia,Uruguay,3,2,Friendly,Saudi Arabia,27,3,2002,1,-1,5,2781,1,1,Saudi_Arabia,Uruguay,2,1,0.99536,0.14867,11,winner,loser
Germany,Argentina,0,1,Friendly,Germany,17,4,2002,-1,1,1,2782,1,1,Germany,Argentina,2,1,0.86588,0.07414,11,loser,winner
Japan,Costa Rica,1,1,Friendly,Japan,17,4,2002,0,0,2,2783,0,1,Japan,Costa_Rica,2,0,0.19139,0.39895,11,draw,draw
Portugal,Brazil,1,1,Friendly,Portugal,17,4,2002,0,0,2,2784,1,0,Portugal,Brazil,2,0,0.51061,0.54204,11,draw,draw
South Korea,Costa Rica,2,0,Friendly,South Korea,21,4,2002,2,-2,2,2785,0,1,South_Korea,Costa_Rica,2,2,0.37666,0.88084,11,winner,loser
Ecuador,Serbia,1,0,Friendly,United States,8,5,2002,1,-1,1,2786,0,1,Ecuador,Serbia,2,1,0.37072,0.02059,11,winner,loser
United States,Uruguay,2,1,Friendly,United States,12,5,2002,1,-1,3,2787,0,1,United_States,Uruguay,2,1,0.36688,0.72381,11,winner,loser
Saudi Arabia,Senegal,3,2,Friendly,Saudi Arabia,14,5,2002,1,-1,5,2788,1,0,Saudi_Arabia,Senegal,2,1,0.71221,0.04859,11,winner,loser
Wales,Germany,1,0,Friendly,Wales,14,5,2002,1,-1,1,2789,0,1,Wales,Germany,2,1,0.90115,0.54146,11,winner,loser
Switzerland,Canada,1,3,Friendly,Switzerland,15,5,2002,-2,2,4,2790,0,0,Switzerland,Canada,2,2,0.1911,0.60972,11,loser,winner
Denmark,Cameroon,2,1,Friendly,Denmark,17,5,2002,1,-1,3,2791,1,1,Denmark,Cameroon,2,1,0.20404,0.79457,11,winner,loser
France,Belgium,1,2,Friendly,France,18,5,2002,-1,1,3,2792,0,1,France,Belgium,2,1,0.17575,0.27885,11,loser,winner
United States,Netherlands,0,2,Friendly,United States,19,5,2002,-2,2,2,2793,0,1,United_States,Netherlands,2,2,0.42875,0.75283,11,loser,winner
South Korea,England,1,1,Friendly,South Korea,21,5,2002,0,0,2,2794,0,1,South_Korea,England,2,0,0.66353,0.41099,11,draw,draw
Ecuador,Senegal,0,1,Friendly,Japan,23,5,2002,-1,1,1,2795,0,0,Ecuador,Senegal,2,1,0.0684,0.29399,11,loser,winner
Belgium,Costa Rica,1,0,Friendly,Japan,26,5,2002,1,-1,1,2796,1,1,Belgium,Costa_Rica,2,1,0.97562,0.54755,11,winner,loser
Cameroon,England,2,2,Friendly,Japan,26,5,2002,0,0,4,2797,1,1,Cameroon,England,2,0,0.31371,0.12971,11,draw,draw
Denmark,Tunisia,2,1,Friendly,Japan,26,5,2002,1,-1,3,2798,1,1,Denmark,Tunisia,2,1,0.02172,0.40074,11,winner,loser
South Korea,France,2,3,Friendly,South Korea,26,5,2002,-1,1,5,2799,0,0,South_Korea,France,2,1,0.79785,0.02012,11,loser,winner
France,Senegal,0,1,FIFA World Cup,South Korea,31,5,2002,-1,1,1,2800,0,0,France,Senegal,2,1,0.80534,0.42425,11,loser,winner
Germany,Saudi Arabia,8,0,FIFA World Cup,Japan,1,6,2002,8,-8,8,2801,1,1,Germany,Saudi_Arabia,2,8,0.08612,0.40398,11,winner,loser
Uruguay,Denmark,1,2,FIFA World Cup,South Korea,1,6,2002,-1,1,3,2802,1,1,Uruguay,Denmark,2,1,0.41739,0.80499,11,loser,winner
Croatia,Mexico,0,1,FIFA World Cup,Japan,3,6,2002,-1,1,1,2803,0,1,Croatia,Mexico,2,1,0.29258,0.58149,11,loser,winner
Japan,Belgium,2,2,FIFA World Cup,Japan,4,6,2002,0,0,4,2804,0,1,Japan,Belgium,2,0,0.5234,0.23457,11,draw,draw
South Korea,Poland,2,0,FIFA World Cup,South Korea,4,6,2002,2,-2,2,2805,0,0,South_Korea,Poland,2,2,0.89368,0.55443,11,winner,loser
United States,Portugal,3,2,FIFA World Cup,South Korea,5,6,2002,1,-1,5,2806,0,1,United_States,Portugal,2,1,0.73332,0.77537,11,winner,loser
Cameroon,Saudi Arabia,1,0,FIFA World Cup,Japan,6,6,2002,1,-1,1,2807,1,1,Cameroon,Saudi_Arabia,2,1,0.2993,0.77689,11,winner,loser
Denmark,Senegal,1,1,FIFA World Cup,South Korea,6,6,2002,0,0,2,2808,1,0,Denmark,Senegal,2,0,0.86075,0.43641,11,draw,draw
France,Uruguay,0,0,FIFA World Cup,South Korea,6,6,2002,0,0,0,2809,0,1,France,Uruguay,2,0,0.08319,0.73442,11,draw,draw
Argentina,England,0,1,FIFA World Cup,Japan,7,6,2002,-1,1,1,2810,1,1,Argentina,England,2,1,0.64666,0.56568,11,loser,winner
Mexico,Ecuador,2,1,FIFA World Cup,Japan,9,6,2002,1,-1,3,2811,1,0,Mexico,Ecuador,2,1,0.79117,0.43248,11,winner,loser
South Korea,United States,1,1,FIFA World Cup,South Korea,10,6,2002,0,0,2,2812,0,0,South_Korea,United_States,2,0,0.06388,0.71889,11,draw,draw
Portugal,Poland,4,0,FIFA World Cup,South Korea,10,6,2002,4,-4,4,2813,1,0,Portugal,Poland,2,4,0.53345,0.47919,11,winner,loser
Tunisia,Belgium,1,1,FIFA World Cup,Japan,10,6,2002,0,0,2,2814,1,1,Tunisia,Belgium,2,0,0.91018,0.35673,11,draw,draw
Cameroon,Germany,0,2,FIFA World Cup,Japan,11,6,2002,-2,2,2,2815,1,1,Cameroon,Germany,2,2,0.57276,0.77949,11,loser,winner
Denmark,France,2,0,FIFA World Cup,South Korea,11,6,2002,2,-2,2,2816,1,0,Denmark,France,2,2,0.96112,0.91077,11,winner,loser
Senegal,Uruguay,3,3,FIFA World Cup,South Korea,11,6,2002,0,0,6,2817,0,1,Senegal,Uruguay,2,0,0.9517,0.06351,11,draw,draw
Costa Rica,Brazil,2,5,FIFA World Cup,South Korea,13,6,2002,-3,3,7,2818,1,0,Costa_Rica,Brazil,2,3,0.83488,0.64811,11,loser,winner
Ecuador,Croatia,1,0,FIFA World Cup,Japan,13,6,2002,1,-1,1,2819,0,0,Ecuador,Croatia,2,1,0.22939,0.15137,11,winner,loser
Japan,Tunisia,2,0,FIFA World Cup,Japan,14,6,2002,2,-2,2,2820,0,1,Japan,Tunisia,2,2,0.82835,0.20688,11,winner,loser
South Korea,Portugal,1,0,FIFA World Cup,South Korea,14,6,2002,1,-1,1,2821,0,1,South_Korea,Portugal,2,1,0.96908,0.11178,11,winner,loser
Poland,United States,3,1,FIFA World Cup,South Korea,14,6,2002,2,-2,4,2822,0,0,Poland,United_States,2,2,0.85233,0.11589,11,winner,loser
Denmark,England,0,3,FIFA World Cup,Japan,15,6,2002,-3,3,3,2823,1,1,Denmark,England,2,3,0.23219,0.21373,11,loser,winner
Brazil,Belgium,2,0,FIFA World Cup,Japan,17,6,2002,2,-2,2,2824,0,1,Brazil,Belgium,2,2,0.97335,0.38107,11,winner,loser
Mexico,United States,0,2,FIFA World Cup,South Korea,17,6,2002,-2,2,2,2825,1,0,Mexico,United_States,2,2,0.35568,0.26204,11,loser,winner
England,Brazil,1,2,FIFA World Cup,Japan,21,6,2002,-1,1,3,2826,1,0,England,Brazil,2,1,0.74952,0.79847,11,loser,winner
Germany,United States,1,0,FIFA World Cup,South Korea,21,6,2002,1,-1,1,2827,1,0,Germany,United_States,2,1,0.67697,0.75372,11,winner,loser
South Korea,Spain,0,0,FIFA World Cup,South Korea,22,6,2002,0,0,0,2828,0,1,South_Korea,Spain,2,0,0.06845,0.93865,11,draw,draw
South Korea,Germany,0,1,FIFA World Cup,South Korea,25,6,2002,-1,1,1,2829,0,1,South_Korea,Germany,2,1,0.0369,0.78234,11,loser,winner
Germany,Brazil,0,2,FIFA World Cup,Japan,30,6,2002,-2,2,2,2830,1,0,Germany,Brazil,2,2,0.67328,0.19022,11,loser,winner
Croatia,Wales,1,1,Friendly,Croatia,21,8,2002,0,0,2,2831,0,0,Croatia,Wales,2,0,0.99031,0.91694,11,draw,draw
Poland,Belgium,1,1,Friendly,Poland,21,8,2002,0,0,2,2832,0,1,Poland,Belgium,2,0,0.50489,0.72273,11,draw,draw
Tunisia,France,1,1,Friendly,Tunisia,21,8,2002,0,0,2,2833,1,0,Tunisia,France,2,0,0.26037,0.71582,11,draw,draw
England,Portugal,1,1,Friendly,England,7,9,2002,0,0,2,2834,1,1,England,Portugal,2,0,0.48438,0.75666,11,draw,draw
Iran,Morocco,1,1,Friendly,Iran,17,9,2002,0,0,2,2835,1,0,Iran,Morocco,2,0,0.41512,0.50639,11,draw,draw
Portugal,Tunisia,1,1,Friendly,Portugal,12,10,2002,0,0,2,2836,1,1,Portugal,Tunisia,2,0,0.26773,0.04408,11,draw,draw
Costa Rica,Ecuador,1,1,Friendly,Costa Rica,16,10,2002,0,0,2,2837,1,0,Costa_Rica,Ecuador,2,0,0.61603,0.26372,11,draw,draw
Denmark,Poland,2,0,Friendly,Denmark,20,11,2002,2,-2,2,2838,1,0,Denmark,Poland,2,2,0.11654,0.40566,11,winner,loser
Ecuador,Costa Rica,2,2,Friendly,Ecuador,20,11,2002,0,0,4,2839,0,1,Ecuador,Costa_Rica,2,0,0.37945,0.48569,11,draw,draw
France,Serbia,3,0,Friendly,France,20,11,2002,3,-3,3,2840,0,1,France,Serbia,2,3,0.77742,0.25721,11,winner,loser
Germany,Netherlands,1,3,Friendly,Germany,20,11,2002,-2,2,4,2841,1,1,Germany,Netherlands,2,2,0.80581,0.44592,11,loser,winner
Japan,Argentina,0,2,Friendly,Japan,20,11,2002,-2,2,2,2842,0,1,Japan,Argentina,2,2,0.40041,0.58833,11,loser,winner
South Korea,Brazil,2,3,Friendly,South Korea,20,11,2002,-1,1,5,2843,0,0,South_Korea,Brazil,2,1,0.27037,0.94724,11,loser,winner
United States,Canada,4,0,Friendly,United States,18,1,2003,4,-4,4,2844,0,0,United_States,Canada,3,4,0.49657,0.61578,11,winner,loser
Mexico,Argentina,0,1,Friendly,United States,4,2,2003,-1,1,1,2845,1,1,Mexico,Argentina,3,1,0.12317,0.71276,11,loser,winner
Uruguay,Iran,1,1,Lunar New Year Cup,Hong Kong,4,2,2003,0,0,2,2846,1,1,Uruguay,Iran,3,0,0.93364,0.85236,11,draw,draw
United States,Argentina,0,1,Friendly,United States,8,2,2003,-1,1,1,2847,0,1,United_States,Argentina,3,1,0.65542,0.27698,11,loser,winner
Croatia,Poland,0,0,Friendly,Croatia,12,2,2003,0,0,0,2848,0,0,Croatia,Poland,3,0,0.53359,0.64553,11,draw,draw
England,Australia,1,3,Friendly,England,12,2,2003,-2,2,4,2849,1,0,England,Australia,3,2,0.83795,0.04854,11,loser,winner
Morocco,Senegal,1,0,Friendly,France,12,2,2003,1,-1,1,2850,0,0,Morocco,Senegal,3,1,0.1535,0.79449,11,winner,loser
Netherlands,Argentina,1,0,Friendly,Netherlands,12,2,2003,1,-1,1,2851,1,1,Netherlands,Argentina,3,1,0.4882,0.41454,11,winner,loser
Spain,Germany,3,1,Friendly,Spain,12,2,2003,2,-2,4,2852,1,1,Spain,Germany,3,2,0.04033,0.335,11,winner,loser
Tunisia,Ghana,2,2,Friendly,Tunisia,27,3,2003,0,0,4,2853,1,0,Tunisia,Ghana,3,0,0.19021,0.15125,11,draw,draw
Japan,Uruguay,2,2,Friendly,Japan,28,3,2003,0,0,4,2854,0,1,Japan,Uruguay,3,0,0.18593,0.79947,11,draw,draw
Croatia,Belgium,4,0,UEFA Euro qualification,Croatia,29,3,2003,4,-4,4,2855,0,1,Croatia,Belgium,3,4,0.77168,0.37419,11,winner,loser
Portugal,Brazil,2,1,Friendly,Portugal,29,3,2003,1,-1,3,2856,1,0,Portugal,Brazil,3,1,0.01314,0.91162,11,winner,loser
Tunisia,Cameroon,1,0,Friendly,Tunisia,30,3,2003,1,-1,1,2857,1,1,Tunisia,Cameroon,3,1,0.3691,0.43624,11,winner,loser
South Korea,Japan,0,1,Friendly,South Korea,16,4,2003,-1,1,1,2858,0,0,South_Korea,Japan,3,1,0.97822,0.74046,11,loser,winner
Belgium,Poland,3,1,Friendly,Belgium,30,4,2003,2,-2,4,2859,1,0,Belgium,Poland,3,2,0.46896,0.52473,11,winner,loser
Germany,Serbia,1,0,Friendly,Germany,30,4,2003,1,-1,1,2860,1,1,Germany,Serbia,3,1,0.4642,0.17745,11,winner,loser
Mexico,Brazil,0,0,Friendly,Mexico,30,4,2003,0,0,0,2861,1,0,Mexico,Brazil,3,0,0.82721,0.34793,11,draw,draw
Netherlands,Portugal,1,1,Friendly,Netherlands,30,4,2003,0,0,2,2862,1,1,Netherlands,Portugal,3,0,0.14974,0.7441,11,draw,draw
Spain,Ecuador,4,0,Friendly,Spain,30,4,2003,4,-4,4,2863,1,0,Spain,Ecuador,3,4,0.03998,0.61821,11,winner,loser
Tunisia,Senegal,1,0,Friendly,Tunisia,30,4,2003,1,-1,1,2864,1,0,Tunisia,Senegal,3,1,0.59221,0.51979,11,winner,loser
United States,Mexico,0,0,Friendly,United States,8,5,2003,0,0,0,2865,0,1,United_States,Mexico,3,0,0.69101,0.91643,11,draw,draw
United States,Wales,2,0,Friendly,United States,26,5,2003,2,-2,2,2866,0,0,United_States,Wales,3,2,0.09159,0.07547,11,winner,loser
Japan,South Korea,0,1,Friendly,Japan,31,5,2003,-1,1,1,2867,0,0,Japan,South_Korea,3,1,0.74116,0.83147,11,loser,winner
Germany,Canada,4,1,Friendly,Germany,1,6,2003,3,-3,5,2868,1,0,Germany,Canada,3,3,0.80396,0.66918,11,winner,loser
England,Serbia,2,1,Friendly,England,3,6,2003,1,-1,3,2869,1,1,England,Serbia,3,1,0.99256,0.32291,11,winner,loser
Japan,Argentina,1,4,Kirin Cup,Japan,8,6,2003,-3,3,5,2870,0,1,Japan,Argentina,3,3,0.03883,0.76993,11,loser,winner
South Korea,Uruguay,0,2,Friendly,South Korea,8,6,2003,-2,2,2,2871,0,1,South_Korea,Uruguay,3,2,0.92985,0.40443,11,loser,winner
South Korea,Argentina,0,1,Friendly,South Korea,11,6,2003,-1,1,1,2872,0,1,South_Korea,Argentina,3,1,0.31235,0.11499,11,loser,winner
Brazil,Cameroon,0,1,Confederations Cup,France,19,6,2003,-1,1,1,2873,0,1,Brazil,Cameroon,3,1,0.09416,0.16877,11,loser,winner
France,Japan,2,1,Confederations Cup,France,20,6,2003,1,-1,3,2874,0,0,France,Japan,3,1,0.95958,0.09432,11,winner,loser
Brazil,United States,1,0,Confederations Cup,France,21,6,2003,1,-1,1,2875,0,0,Brazil,United_States,3,1,0.80059,0.06896,11,winner,loser
United States,Cameroon,0,0,Confederations Cup,France,23,6,2003,0,0,0,2876,0,1,United_States,Cameroon,3,0,0.18576,0.21315,11,draw,draw
France,Cameroon,1,0,Confederations Cup,France,29,6,2003,1,-1,1,2877,0,1,France,Cameroon,3,1,0.08294,0.98391,11,winner,loser
Costa Rica,Canada,0,1,Gold Cup,United States,12,7,2003,-1,1,1,2878,1,0,Costa_Rica,Canada,3,1,0.13958,0.78748,11,loser,winner
Mexico,Brazil,1,0,Gold Cup,Mexico,13,7,2003,1,-1,1,2879,1,0,Mexico,Brazil,3,1,0.63258,0.69934,11,winner,loser
Argentina,Uruguay,2,2,Friendly,Argentina,16,7,2003,0,0,4,2880,1,1,Argentina,Uruguay,3,0,0.49372,0.73314,11,draw,draw
United States,Brazil,1,2,Gold Cup,United States,23,7,2003,-1,1,3,2881,0,0,United_States,Brazil,3,1,0.62207,0.59183,11,loser,winner
Mexico,Costa Rica,2,0,Gold Cup,Mexico,24,7,2003,2,-2,2,2882,1,1,Mexico,Costa_Rica,3,2,0.31401,0.99027,11,winner,loser
United States,Costa Rica,3,2,Gold Cup,United States,26,7,2003,1,-1,5,2883,0,1,United_States,Costa_Rica,3,1,0.53885,0.65073,11,winner,loser
Mexico,Brazil,1,0,Gold Cup,Mexico,27,7,2003,1,-1,1,2884,1,0,Mexico,Brazil,3,1,0.96402,0.67353,11,winner,loser
Argentina,Uruguay,3,2,Friendly,Italy,20,8,2003,1,-1,5,2885,1,1,Argentina,Uruguay,3,1,0.69487,0.37574,11,winner,loser
Belgium,Netherlands,1,1,Friendly,Belgium,20,8,2003,0,0,2,2886,1,1,Belgium,Netherlands,3,0,0.11713,0.1833,11,draw,draw
England,Croatia,3,1,Friendly,England,20,8,2003,2,-2,4,2887,1,0,England,Croatia,3,2,0.55989,0.39667,11,winner,loser
Serbia,Wales,1,0,UEFA Euro qualification,Serbia and Montenegro,20,8,2003,1,-1,1,2888,1,0,Serbia,Wales,3,1,0.76957,0.24094,11,winner,loser
Switzerland,France,0,2,Friendly,Switzerland,20,8,2003,-2,2,2,2889,0,0,Switzerland,France,3,2,0.4717,0.99691,11,loser,winner
Portugal,Spain,0,3,Friendly,Portugal,6,9,2003,-3,3,3,2890,1,1,Portugal,Spain,3,3,0.39233,0.41917,11,loser,winner
Belgium,Croatia,2,1,UEFA Euro qualification,Belgium,10,9,2003,1,-1,3,2891,1,0,Belgium,Croatia,3,1,0.28127,0.90046,11,winner,loser
Brazil,Ecuador,1,0,FIFA World Cup qualification,Brazil,10,9,2003,1,-1,1,2892,0,0,Brazil,Ecuador,3,1,0.58949,0.65493,11,winner,loser
Japan,Senegal,0,1,Friendly,Japan,10,9,2003,-1,1,1,2893,0,0,Japan,Senegal,3,1,0.42478,0.64245,11,loser,winner
Tunisia,Japan,0,1,Friendly,Tunisia,8,10,2003,-1,1,1,2894,1,0,Tunisia,Japan,3,1,0.08529,0.51074,11,loser,winner
Tunisia,Morocco,0,0,Friendly,Tunisia,11,10,2003,0,0,0,2895,1,0,Tunisia,Morocco,3,0,0.94757,0.32307,11,draw,draw
Wales,Serbia,2,3,UEFA Euro qualification,Wales,11,10,2003,-1,1,5,2896,0,1,Wales,Serbia,3,1,0.92769,0.7003,11,loser,winner
Mexico,Uruguay,0,2,Friendly,United States,15,10,2003,-2,2,2,2897,1,1,Mexico,Uruguay,3,2,0.59503,0.05892,11,loser,winner
Germany,France,0,3,Friendly,Germany,15,11,2003,-3,3,3,2898,1,0,Germany,France,3,3,0.7137,0.78968,11,loser,winner
England,Denmark,2,3,Friendly,England,16,11,2003,-1,1,5,2899,1,1,England,Denmark,3,1,0.47478,0.30805,11,loser,winner
Poland,Serbia,4,3,Friendly,Poland,16,11,2003,1,-1,7,2900,0,1,Poland,Serbia,3,1,0.49744,0.67357,11,winner,loser
Brazil,Uruguay,3,3,FIFA World Cup qualification,Brazil,19,11,2003,0,0,6,2901,0,1,Brazil,Uruguay,3,0,0.23651,0.25609,11,draw,draw
Japan,Cameroon,0,0,Friendly,Japan,19,11,2003,0,0,0,2902,0,1,Japan,Cameroon,3,0,0.69561,0.55708,11,draw,draw
Japan,South Korea,0,0,EAFF Championship,Japan,10,12,2003,0,0,0,2903,0,0,Japan,South_Korea,3,0,0.46909,0.88586,11,draw,draw
Saudi Arabia,Qatar,0,0,Gulf Cup,Kuwait,29,12,2003,0,0,0,2904,1,0,Saudi_Arabia,Qatar,3,0,0.06018,0.8166,11,draw,draw
Tunisia,Senegal,1,0,African Cup of Nations,Tunisia,7,2,2004,1,-1,1,2905,1,0,Tunisia,Senegal,4,1,0.9248,0.55745,11,winner,loser
Tunisia,Morocco,2,1,African Cup of Nations,Tunisia,14,2,2004,1,-1,3,2906,1,0,Tunisia,Morocco,4,1,0.84322,0.00133,11,winner,loser
Belgium,France,0,2,Friendly,Belgium,18,2,2004,-2,2,2,2907,1,0,Belgium,France,4,2,0.7173,0.61186,11,loser,winner
Croatia,Germany,1,2,Friendly,Croatia,18,2,2004,-1,1,3,2908,0,1,Croatia,Germany,4,1,0.62035,0.06405,11,loser,winner
Iran,Qatar,3,1,FIFA World Cup qualification,Iran,18,2,2004,2,-2,4,2909,1,0,Iran,Qatar,4,2,0.58248,0.90233,11,winner,loser
Morocco,Switzerland,2,1,Friendly,Morocco,18,2,2004,1,-1,3,2910,0,0,Morocco,Switzerland,4,1,0.88733,0.17472,11,winner,loser
Netherlands,United States,1,0,Friendly,Netherlands,18,2,2004,1,-1,1,2911,1,0,Netherlands,United_States,4,1,0.77918,0.51352,11,winner,loser
Portugal,England,1,1,Friendly,Portugal,18,2,2004,0,0,2,2912,1,1,Portugal,England,4,0,0.28447,0.67707,11,draw,draw
Mexico,Ecuador,2,1,Friendly,Mexico,10,3,2004,1,-1,3,2913,1,0,Mexico,Ecuador,4,1,0.42495,0.61499,11,winner,loser
Argentina,Ecuador,1,0,FIFA World Cup qualification,Argentina,30,3,2004,1,-1,1,2914,1,0,Argentina,Ecuador,4,1,0.78485,0.83523,11,winner,loser
Germany,Belgium,3,0,Friendly,Germany,31,3,2004,3,-3,3,2915,1,1,Germany,Belgium,4,3,0.95207,0.83856,11,winner,loser
Mexico,Costa Rica,2,0,Friendly,United States,31,3,2004,2,-2,2,2916,1,1,Mexico,Costa_Rica,4,2,0.11023,0.63743,11,winner,loser
Netherlands,France,0,0,Friendly,Netherlands,31,3,2004,0,0,0,2917,1,0,Netherlands,France,4,0,0.08526,0.86195,11,draw,draw
Poland,United States,0,1,Friendly,Poland,31,3,2004,-1,1,1,2918,0,0,Poland,United_States,4,1,0.57013,0.94303,11,loser,winner
Spain,Denmark,2,0,Friendly,Spain,31,3,2004,2,-2,2,2919,1,1,Spain,Denmark,4,2,0.70906,0.28974,11,winner,loser
Morocco,Argentina,0,1,Friendly,Morocco,28,4,2004,-1,1,1,2920,0,1,Morocco,Argentina,4,1,0.70638,0.41979,11,loser,winner
United States,Mexico,1,0,Friendly,United States,28,4,2004,1,-1,1,2921,0,1,United_States,Mexico,4,1,0.69566,0.88715,11,winner,loser
France,Brazil,0,0,Friendly,France,20,5,2004,0,0,0,2922,0,0,France,Brazil,4,0,0.35278,0.0239,11,draw,draw
Netherlands,Belgium,0,1,Friendly,Netherlands,29,5,2004,-1,1,1,2923,1,1,Netherlands,Belgium,4,1,0.32151,0.91042,11,loser,winner
Wales,Canada,1,0,Friendly,Wales,30,5,2004,1,-1,1,2924,0,0,Wales,Canada,4,1,0.54403,0.82895,11,winner,loser
England,Japan,1,1,Friendly,England,1,6,2004,0,0,2,2925,1,0,England,Japan,4,0,0.25893,0.60015,11,draw,draw
Brazil,Argentina,3,1,FIFA World Cup qualification,Brazil,2,6,2004,2,-2,4,2926,0,1,Brazil,Argentina,4,2,0.61265,0.40112,11,winner,loser
Switzerland,Germany,0,2,Friendly,Switzerland,2,6,2004,-2,2,2,2927,0,1,Switzerland,Germany,4,2,0.16414,0.39223,11,loser,winner
Denmark,Croatia,1,2,Friendly,Denmark,5,6,2004,-1,1,3,2928,1,0,Denmark,Croatia,4,1,0.76365,0.5762,11,loser,winner
France,England,2,1,UEFA Euro,Portugal,13,6,2004,1,-1,3,2929,0,1,France,England,4,1,0.70814,0.10574,11,winner,loser
Switzerland,Croatia,0,0,UEFA Euro,Portugal,13,6,2004,0,0,0,2930,0,0,Switzerland,Croatia,4,0,0.20463,0.63538,11,draw,draw
Germany,Netherlands,1,1,UEFA Euro,Portugal,15,6,2004,0,0,2,2931,1,1,Germany,Netherlands,4,0,0.0013,0.38604,11,draw,draw
Croatia,France,2,2,UEFA Euro,Portugal,17,6,2004,0,0,4,2932,0,0,Croatia,France,4,0,0.91964,0.45354,11,draw,draw
England,Switzerland,3,0,UEFA Euro,Portugal,17,6,2004,3,-3,3,2933,1,0,England,Switzerland,4,3,0.1596,0.70853,11,winner,loser
Portugal,Spain,1,0,UEFA Euro,Portugal,20,6,2004,1,-1,1,2934,1,1,Portugal,Spain,4,1,0.92793,0.74395,11,winner,loser
Croatia,England,2,4,UEFA Euro,Portugal,21,6,2004,-2,2,6,2935,0,1,Croatia,England,4,2,0.89232,0.34757,11,loser,winner
Switzerland,France,1,3,UEFA Euro,Portugal,21,6,2004,-2,2,4,2936,0,0,Switzerland,France,4,2,0.65608,0.31007,11,loser,winner
Portugal,England,2,2,UEFA Euro,Portugal,24,6,2004,0,0,4,2937,1,1,Portugal,England,4,0,0.01676,0.03421,11,draw,draw
Portugal,Netherlands,2,1,UEFA Euro,Portugal,30,6,2004,1,-1,3,2938,1,1,Portugal,Netherlands,4,1,0.97892,0.59102,11,winner,loser
Argentina,Ecuador,6,1,Copa America,Peru,7,7,2004,5,-5,7,2939,1,0,Argentina,Ecuador,4,5,0.40161,0.19431,11,winner,loser
Mexico,Uruguay,2,2,Copa America,Peru,7,7,2004,0,0,4,2940,1,1,Mexico,Uruguay,4,0,0.14704,0.3525,11,draw,draw
Argentina,Mexico,0,1,Copa America,Peru,10,7,2004,-1,1,1,2941,1,1,Argentina,Mexico,4,1,0.74743,0.47605,11,loser,winner
Uruguay,Ecuador,2,1,Copa America,Peru,10,7,2004,1,-1,3,2942,1,0,Uruguay,Ecuador,4,1,0.15544,0.17265,11,winner,loser
Brazil,Costa Rica,4,1,Copa America,Peru,11,7,2004,3,-3,5,2943,0,1,Brazil,Costa_Rica,4,3,0.89962,0.41391,11,winner,loser
United States,Poland,1,1,Friendly,United States,11,7,2004,0,0,2,2944,0,0,United_States,Poland,4,0,0.44329,0.65485,11,draw,draw
Argentina,Uruguay,4,2,Copa America,Peru,13,7,2004,2,-2,6,2945,1,1,Argentina,Uruguay,4,2,0.23407,0.94889,11,winner,loser
Japan,Serbia,1,0,Kirin Cup,Japan,13,7,2004,1,-1,1,2946,0,1,Japan,Serbia,4,1,0.66793,0.30138,11,winner,loser
Mexico,Ecuador,2,1,Copa America,Peru,13,7,2004,1,-1,3,2947,1,0,Mexico,Ecuador,4,1,0.08785,0.61467,11,winner,loser
Mexico,Brazil,0,4,Copa America,Peru,18,7,2004,-4,4,4,2948,1,0,Mexico,Brazil,4,4,0.09164,0.31654,11,loser,winner
Uruguay,Brazil,1,1,Copa America,Peru,21,7,2004,0,0,2,2949,1,0,Uruguay,Brazil,4,0,0.46071,0.52041,11,draw,draw
Argentina,Brazil,2,2,Copa America,Peru,25,7,2004,0,0,4,2950,1,0,Argentina,Brazil,4,0,0.51364,0.67593,11,draw,draw
Japan,Iran,0,0,AFC Asian Cup,China PR,28,7,2004,0,0,0,2951,0,1,Japan,Iran,4,0,0.80755,0.49301,11,draw,draw
South Korea,Iran,3,4,AFC Asian Cup,China PR,31,7,2004,-1,1,7,2952,0,1,South_Korea,Iran,4,1,0.95939,0.1372,11,loser,winner
Japan,Argentina,1,2,Friendly,Japan,18,8,2004,-1,1,3,2953,0,1,Japan,Argentina,4,1,0.69877,0.88207,11,loser,winner
Poland,Denmark,1,5,Friendly,Poland,18,8,2004,-4,4,6,2954,0,1,Poland,Denmark,4,4,0.8002,0.56227,11,loser,winner
Morocco,Tunisia,1,1,FIFA World Cup qualification,Morocco,4,9,2004,0,0,2,2955,0,1,Morocco,Tunisia,4,0,0.6317,0.76756,11,draw,draw
Uruguay,Ecuador,1,0,FIFA World Cup qualification,Uruguay,5,9,2004,1,-1,1,2956,1,0,Uruguay,Ecuador,4,1,0.8537,0.05238,11,winner,loser
Costa Rica,Canada,1,0,FIFA World Cup qualification,Costa Rica,8,9,2004,1,-1,1,2957,1,0,Costa_Rica,Canada,4,1,0.57767,0.79533,11,winner,loser
Germany,Brazil,1,1,Friendly,Germany,8,9,2004,0,0,2,2958,1,0,Germany,Brazil,4,0,0.71464,0.58236,11,draw,draw
Poland,England,1,2,FIFA World Cup qualification,Poland,8,9,2004,-1,1,3,2959,0,1,Poland,England,4,1,0.32351,0.20148,11,loser,winner
Argentina,Uruguay,4,2,FIFA World Cup qualification,Argentina,9,10,2004,2,-2,6,2960,1,1,Argentina,Uruguay,4,2,0.47025,0.27299,11,winner,loser
England,Wales,2,0,FIFA World Cup qualification,England,9,10,2004,2,-2,2,2961,1,0,England,Wales,4,2,0.0339,0.28731,11,winner,loser
Iran,Germany,0,2,Friendly,Iran,9,10,2004,-2,2,2,2962,1,1,Iran,Germany,4,2,0.03324,0.32219,11,loser,winner
Spain,Belgium,2,0,FIFA World Cup qualification,Spain,9,10,2004,2,-2,2,2963,1,1,Spain,Belgium,4,2,0.54098,0.66043,11,winner,loser
Canada,Costa Rica,1,3,FIFA World Cup qualification,Canada,13,10,2004,-2,2,4,2964,0,1,Canada,Costa_Rica,4,2,0.87952,0.1951,11,loser,winner
Qatar,Iran,2,3,FIFA World Cup qualification,Qatar,13,10,2004,-1,1,5,2965,0,1,Qatar,Iran,4,1,0.52218,0.8289,11,loser,winner
Wales,Poland,2,3,FIFA World Cup qualification,Wales,13,10,2004,-1,1,5,2966,0,0,Wales,Poland,4,1,0.0244,0.0977,11,loser,winner
Mexico,Ecuador,2,1,Friendly,United States,27,10,2004,1,-1,3,2967,1,0,Mexico,Ecuador,4,1,0.09595,0.02649,11,winner,loser
Belgium,Serbia,0,2,FIFA World Cup qualification,Belgium,17,11,2004,-2,2,2,2968,1,1,Belgium,Serbia,4,2,0.18628,0.01619,11,loser,winner
Ecuador,Brazil,1,0,FIFA World Cup qualification,Ecuador,17,11,2004,1,-1,1,2969,0,0,Ecuador,Brazil,4,1,0.90955,0.37512,11,winner,loser
France,Poland,0,0,Friendly,France,17,11,2004,0,0,0,2970,0,0,France,Poland,4,0,0.85044,0.78713,11,draw,draw
Germany,Cameroon,3,0,Friendly,Germany,17,11,2004,3,-3,3,2971,1,1,Germany,Cameroon,4,3,0.40486,0.29521,11,winner,loser
Spain,England,1,0,Friendly,Spain,17,11,2004,1,-1,1,2972,1,1,Spain,England,4,1,0.40496,0.08934,11,winner,loser
Japan,Germany,0,3,Friendly,Japan,16,12,2004,-3,3,3,2973,0,1,Japan,Germany,4,3,0.06946,0.46597,11,loser,winner
South Korea,Germany,3,1,Friendly,South Korea,19,12,2004,2,-2,4,2974,0,1,South_Korea,Germany,4,2,0.69723,0.46917,11,winner,loser
Cameroon,Senegal,1,0,Friendly,France,9,2,2005,1,-1,1,2975,1,0,Cameroon,Senegal,5,1,0.97637,0.81086,11,winner,loser
Costa Rica,Mexico,1,2,FIFA World Cup qualification,Costa Rica,9,2,2005,-1,1,3,2976,1,1,Costa_Rica,Mexico,5,1,0.82087,0.24874,11,loser,winner
England,Netherlands,0,0,Friendly,England,9,2,2005,0,0,0,2977,1,1,England,Netherlands,5,0,0.83252,0.49176,11,draw,draw
Germany,Argentina,2,2,Friendly,Germany,9,2,2005,0,0,4,2978,1,1,Germany,Argentina,5,0,0.31268,0.82057,11,draw,draw
Costa Rica,Ecuador,1,2,Friendly,Costa Rica,16,2,2005,-1,1,3,2979,1,0,Costa_Rica,Ecuador,5,1,0.0699,0.1617,11,loser,winner
Mexico,Argentina,1,1,Friendly,United States,9,3,2005,0,0,2,2980,1,1,Mexico,Argentina,5,0,0.13924,0.70247,11,draw,draw
Iran,Japan,2,1,FIFA World Cup qualification,Iran,25,3,2005,1,-1,3,2981,1,0,Iran,Japan,5,1,0.74019,0.10801,11,winner,loser
Saudi Arabia,South Korea,2,0,FIFA World Cup qualification,Saudi Arabia,25,3,2005,2,-2,2,2982,1,0,Saudi_Arabia,South_Korea,5,2,0.84801,0.39564,11,winner,loser
France,Switzerland,0,0,FIFA World Cup qualification,France,26,3,2005,0,0,0,2983,0,0,France,Switzerland,5,0,0.08151,0.44858,11,draw,draw
Portugal,Canada,4,1,Friendly,Portugal,26,3,2005,3,-3,5,2984,1,0,Portugal,Canada,5,3,0.34087,0.2581,11,winner,loser
Mexico,United States,2,1,FIFA World Cup qualification,Mexico,27,3,2005,1,-1,3,2985,1,0,Mexico,United_States,5,1,0.43212,0.8339,11,winner,loser
Serbia,Spain,0,0,FIFA World Cup qualification,Serbia and Montenegro,30,3,2005,0,0,0,2986,1,1,Serbia,Spain,5,0,0.24444,0.8669,11,draw,draw
Uruguay,Brazil,1,1,FIFA World Cup qualification,Uruguay,30,3,2005,0,0,2,2987,1,0,Uruguay,Brazil,5,0,0.40015,0.04478,11,draw,draw
Mexico,Poland,1,1,Friendly,United States,27,4,2005,0,0,2,2988,1,0,Mexico,Poland,5,0,0.02538,0.86688,11,draw,draw
United States,England,1,2,Friendly,United States,28,5,2005,-1,1,3,2989,0,1,United_States,England,5,1,0.46901,0.68476,11,loser,winner
Ecuador,Argentina,2,0,FIFA World Cup qualification,Ecuador,4,6,2005,2,-2,2,2990,0,1,Ecuador,Argentina,5,2,0.48645,0.56404,11,winner,loser
Serbia,Belgium,0,0,FIFA World Cup qualification,Serbia and Montenegro,4,6,2005,0,0,0,2991,1,1,Serbia,Belgium,5,0,0.26088,0.4978,11,draw,draw
United States,Costa Rica,3,0,FIFA World Cup qualification,United States,4,6,2005,3,-3,3,2992,0,1,United_States,Costa_Rica,5,3,0.20657,0.39904,11,winner,loser
Argentina,Brazil,3,1,FIFA World Cup qualification,Argentina,8,6,2005,2,-2,4,2993,1,0,Argentina,Brazil,5,2,0.04584,0.19272,11,winner,loser
Argentina,Tunisia,2,1,Confederations Cup,Germany,15,6,2005,1,-1,3,2994,1,1,Argentina,Tunisia,5,1,0.9877,0.06805,11,winner,loser
Germany,Australia,4,3,Confederations Cup,Germany,15,6,2005,1,-1,7,2995,1,0,Germany,Australia,5,1,0.83307,0.91128,11,winner,loser
Japan,Mexico,1,2,Confederations Cup,Germany,16,6,2005,-1,1,3,2996,0,1,Japan,Mexico,5,1,0.59482,0.24807,11,loser,winner
Australia,Argentina,2,4,Confederations Cup,Germany,18,6,2005,-2,2,6,2997,0,1,Australia,Argentina,5,2,0.78801,0.85191,11,loser,winner
Germany,Tunisia,3,0,Confederations Cup,Germany,18,6,2005,3,-3,3,2998,1,1,Germany,Tunisia,5,3,0.70161,0.51226,11,winner,loser
Mexico,Brazil,1,0,Confederations Cup,Germany,19,6,2005,1,-1,1,2999,1,0,Mexico,Brazil,5,1,0.93034,0.05919,11,winner,loser
Australia,Tunisia,0,2,Confederations Cup,Germany,21,6,2005,-2,2,2,3000,0,1,Australia,Tunisia,5,2,0.04623,0.91868,11,loser,winner
Germany,Argentina,2,2,Confederations Cup,Germany,21,6,2005,0,0,4,3001,1,1,Germany,Argentina,5,0,0.4823,0.91199,11,draw,draw
Japan,Brazil,2,2,Confederations Cup,Germany,22,6,2005,0,0,4,3002,0,0,Japan,Brazil,5,0,0.29354,0.18155,11,draw,draw
Germany,Brazil,2,3,Confederations Cup,Germany,25,6,2005,-1,1,5,3003,1,0,Germany,Brazil,5,1,0.47671,0.56915,11,loser,winner
Mexico,Argentina,1,1,Confederations Cup,Germany,26,6,2005,0,0,2,3004,1,1,Mexico,Argentina,5,0,0.02559,0.39791,11,draw,draw
Brazil,Argentina,4,1,Confederations Cup,Germany,29,6,2005,3,-3,5,3005,0,1,Brazil,Argentina,5,3,0.02704,0.28411,11,winner,loser
Germany,Mexico,4,3,Confederations Cup,Germany,29,6,2005,1,-1,7,3006,1,1,Germany,Mexico,5,1,0.77339,0.57854,11,winner,loser
Canada,Costa Rica,0,1,Gold Cup,United States,7,7,2005,-1,1,1,3007,0,1,Canada,Costa_Rica,5,1,0.26516,0.0472,11,loser,winner
United States,Canada,2,0,Gold Cup,United States,9,7,2005,2,-2,2,3008,0,0,United_States,Canada,5,2,0.78506,0.52881,11,winner,loser
United States,Costa Rica,0,0,Gold Cup,United States,12,7,2005,0,0,0,3009,0,1,United_States,Costa_Rica,5,0,0.52809,0.02554,11,draw,draw
South Korea,Japan,0,1,EAFF Championship,South Korea,7,8,2005,-1,1,1,3010,0,0,South_Korea,Japan,5,1,0.00202,0.80177,11,loser,winner
Poland,Serbia,3,2,Friendly,Ukraine,15,8,2005,1,-1,5,3011,0,1,Poland,Serbia,5,1,0.73522,0.8795,11,winner,loser
Croatia,Brazil,1,1,Friendly,Croatia,17,8,2005,0,0,2,3012,0,0,Croatia,Brazil,5,0,0.81721,0.18718,11,draw,draw
Denmark,England,4,1,Friendly,Denmark,17,8,2005,3,-3,5,3013,1,1,Denmark,England,5,3,0.99867,0.13917,11,winner,loser
Japan,Iran,2,1,FIFA World Cup qualification,Japan,17,8,2005,1,-1,3,3014,0,1,Japan,Iran,5,1,0.55798,0.78865,11,winner,loser
South Korea,Saudi Arabia,0,1,FIFA World Cup qualification,South Korea,17,8,2005,-1,1,1,3015,0,1,South_Korea,Saudi_Arabia,5,1,0.96644,0.55618,11,loser,winner
Mexico,Costa Rica,2,0,FIFA World Cup qualification,Mexico,17,8,2005,2,-2,2,3016,1,1,Mexico,Costa_Rica,5,2,0.39756,0.01905,11,winner,loser
Netherlands,Germany,2,2,Friendly,Netherlands,17,8,2005,0,0,4,3017,1,1,Netherlands,Germany,5,0,0.42085,0.7919,11,draw,draw
Senegal,Ghana,0,0,Friendly,England,17,8,2005,0,0,0,3018,0,0,Senegal,Ghana,5,0,0.7775,0.56912,11,draw,draw
Spain,Uruguay,2,0,Friendly,Spain,17,8,2005,2,-2,2,3019,1,1,Spain,Uruguay,5,2,0.3844,0.28998,11,winner,loser
Spain,Canada,2,1,Friendly,Spain,3,9,2005,1,-1,3,3020,1,0,Spain,Canada,5,1,0.5454,0.66778,11,winner,loser
United States,Mexico,2,0,FIFA World Cup qualification,United States,3,9,2005,2,-2,2,3021,0,1,United_States,Mexico,5,2,0.6412,0.55584,11,winner,loser
Wales,England,0,1,FIFA World Cup qualification,Wales,3,9,2005,-1,1,1,3022,0,1,Wales,England,5,1,0.80983,0.40926,11,loser,winner
Poland,Wales,1,0,FIFA World Cup qualification,Poland,7,9,2005,1,-1,1,3023,0,0,Poland,Wales,5,1,0.51401,0.25374,11,winner,loser
Spain,Serbia,1,1,FIFA World Cup qualification,Spain,7,9,2005,0,0,2,3024,1,1,Spain,Serbia,5,0,0.48464,0.55838,11,draw,draw
Belgium,Spain,0,2,FIFA World Cup qualification,Belgium,8,10,2005,-2,2,2,3025,1,1,Belgium,Spain,5,2,0.08185,0.16944,11,loser,winner
Costa Rica,United States,3,0,FIFA World Cup qualification,Costa Rica,8,10,2005,3,-3,3,3026,1,0,Costa_Rica,United_States,5,3,0.30184,0.68303,11,winner,loser
Ecuador,Uruguay,0,0,FIFA World Cup qualification,Ecuador,8,10,2005,0,0,0,3027,0,1,Ecuador,Uruguay,5,0,0.56081,0.41524,11,draw,draw
Switzerland,France,1,1,FIFA World Cup qualification,Switzerland,8,10,2005,0,0,2,3028,0,0,Switzerland,France,5,0,0.17662,0.20033,11,draw,draw
Tunisia,Morocco,2,2,FIFA World Cup qualification,Tunisia,8,10,2005,0,0,4,3029,1,0,Tunisia,Morocco,5,0,0.57939,0.43727,11,draw,draw
England,Poland,2,1,FIFA World Cup qualification,England,12,10,2005,1,-1,3,3030,1,0,England,Poland,5,1,0.19917,0.83625,11,winner,loser
South Korea,Iran,2,0,Friendly,South Korea,12,10,2005,2,-2,2,3031,0,1,South_Korea,Iran,5,2,0.52883,0.36542,11,winner,loser
Uruguay,Argentina,1,0,FIFA World Cup qualification,Uruguay,12,10,2005,1,-1,1,3032,1,1,Uruguay,Argentina,5,1,0.62296,0.06421,11,winner,loser
Mexico,Uruguay,3,1,Friendly,Mexico,26,10,2005,2,-2,4,3033,1,1,Mexico,Uruguay,5,2,0.96823,0.79913,11,winner,loser
France,Costa Rica,3,2,Friendly,Martinique,9,11,2005,1,-1,5,3034,0,1,France,Costa_Rica,5,1,0.86635,0.15512,11,winner,loser
England,Argentina,3,2,Friendly,Switzerland,12,11,2005,1,-1,5,3035,1,1,England,Argentina,5,1,0.15558,0.80081,11,winner,loser
France,Germany,0,0,Friendly,France,12,11,2005,0,0,0,3036,0,1,France,Germany,5,0,0.65634,0.82789,11,draw,draw
Portugal,Croatia,2,0,Friendly,Portugal,12,11,2005,2,-2,2,3037,1,0,Portugal,Croatia,5,2,0.31502,0.84982,11,winner,loser
Uruguay,Australia,1,0,FIFA World Cup qualification,Uruguay,12,11,2005,1,-1,1,3038,1,0,Uruguay,Australia,5,1,0.63422,0.61198,11,winner,loser
Ecuador,Poland,0,3,Friendly,Spain,13,11,2005,-3,3,3,3039,0,0,Ecuador,Poland,5,3,0.30466,0.64996,11,loser,winner
Saudi Arabia,Ghana,1,3,Friendly,Saudi Arabia,14,11,2005,-2,2,4,3040,1,0,Saudi_Arabia,Ghana,5,2,0.93338,0.42512,11,loser,winner
Morocco,Cameroon,0,0,Friendly,France,15,11,2005,0,0,0,3041,0,1,Morocco,Cameroon,5,0,0.13683,0.70562,11,draw,draw
Australia,Uruguay,1,0,FIFA World Cup qualification,Australia,16,11,2005,1,-1,1,3042,0,1,Australia,Uruguay,5,1,0.9218,0.66886,11,winner,loser
South Korea,Serbia,2,0,Friendly,South Korea,16,11,2005,2,-2,2,3043,0,1,South_Korea,Serbia,5,2,0.55309,0.01848,11,winner,loser
Qatar,Argentina,0,3,Friendly,Qatar,16,11,2005,-3,3,3,3044,0,1,Qatar,Argentina,5,3,0.24979,0.43474,11,loser,winner
Ecuador,Senegal,1,2,Friendly,Egypt,27,12,2005,-1,1,3,3045,0,0,Ecuador,Senegal,5,1,0.90947,0.76357,11,loser,winner
Tunisia,Ghana,2,0,Friendly,Tunisia,15,1,2006,2,-2,2,3046,1,0,Tunisia,Ghana,6,2,0.68421,0.86205,11,winner,loser
United States,Canada,0,0,Friendly,United States,22,1,2006,0,0,0,3047,0,0,United_States,Canada,6,0,0.84355,0.98089,11,draw,draw
Ghana,Senegal,1,0,African Cup of Nations,Egypt,27,1,2006,1,-1,1,3048,0,0,Ghana,Senegal,6,1,0.33669,0.78363,11,winner,loser
South Korea,Croatia,2,0,Lunar New Year Cup,Hong Kong,29,1,2006,2,-2,2,3049,0,0,South_Korea,Croatia,6,2,0.82358,0.06627,11,winner,loser
United States,Japan,3,2,Friendly,United States,10,2,2006,1,-1,5,3050,0,0,United_States,Japan,6,1,0.7866,0.23935,11,winner,loser
Costa Rica,South Korea,1,0,Friendly,United States,11,2,2006,1,-1,1,3051,1,0,Costa_Rica,South_Korea,6,1,0.94263,0.01693,11,winner,loser
Mexico,South Korea,0,1,Friendly,United States,15,2,2006,-1,1,1,3052,1,0,Mexico,South_Korea,6,1,0.43001,0.29161,11,loser,winner
Argentina,Croatia,2,3,Friendly,Switzerland,1,3,2006,-1,1,5,3053,1,0,Argentina,Croatia,6,1,0.40981,0.74618,11,loser,winner
England,Uruguay,2,1,Friendly,England,1,3,2006,1,-1,3,3054,1,1,England,Uruguay,6,1,0.56648,0.13275,11,winner,loser
Iran,Costa Rica,3,2,Friendly,Iran,1,3,2006,1,-1,5,3055,1,1,Iran,Costa_Rica,6,1,0.67342,8.20E-04,11,winner,loser
Mexico,Ghana,1,0,Friendly,United States,1,3,2006,1,-1,1,3056,1,0,Mexico,Ghana,6,1,0.69699,0.12131,11,winner,loser
Netherlands,Ecuador,1,0,Friendly,Netherlands,1,3,2006,1,-1,1,3057,1,0,Netherlands,Ecuador,6,1,0.45706,0.74523,11,winner,loser
Poland,United States,0,1,Friendly,Germany,1,3,2006,-1,1,1,3058,0,0,Poland,United_States,6,1,0.89064,0.96721,11,loser,winner
Saudi Arabia,Portugal,0,3,Friendly,Germany,1,3,2006,-3,3,3,3059,1,1,Saudi_Arabia,Portugal,6,3,0.68076,0.2555,11,loser,winner
Tunisia,Serbia,0,1,Friendly,Tunisia,1,3,2006,-1,1,1,3060,1,1,Tunisia,Serbia,6,1,0.32322,0.14997,11,loser,winner
Germany,United States,4,1,Friendly,Germany,22,3,2006,3,-3,5,3061,1,0,Germany,United_States,6,3,0.33699,0.99322,11,winner,loser
Saudi Arabia,Poland,1,2,Friendly,Saudi Arabia,28,3,2006,-1,1,3,3062,1,0,Saudi_Arabia,Poland,6,1,0.12782,0.17994,11,loser,winner
Japan,Ecuador,1,0,Friendly,Japan,30,3,2006,1,-1,1,3063,0,0,Japan,Ecuador,6,1,0.20123,0.21053,11,winner,loser
Belgium,Saudi Arabia,2,1,Friendly,Netherlands,11,5,2006,1,-1,3,3064,1,1,Belgium,Saudi_Arabia,6,1,0.39338,0.34888,11,winner,loser
South Korea,Senegal,1,1,Friendly,South Korea,23,5,2006,0,0,2,3065,0,0,South_Korea,Senegal,6,0,0.19342,0.79693,11,draw,draw
United States,Morocco,0,1,Friendly,United States,23,5,2006,-1,1,1,3066,0,0,United_States,Morocco,6,1,0.38946,0.26568,11,loser,winner
France,Mexico,1,0,Friendly,France,27,5,2006,1,-1,1,3067,0,1,France,Mexico,6,1,0.91732,0.9626,11,winner,loser
Netherlands,Cameroon,1,0,Friendly,Netherlands,27,5,2006,1,-1,1,3068,1,1,Netherlands,Cameroon,6,1,0.89238,0.923,11,winner,loser
Serbia,Uruguay,1,1,Friendly,Serbia and Montenegro,27,5,2006,0,0,2,3069,1,1,Serbia,Uruguay,6,0,0.7112,0.74171,11,draw,draw
Croatia,Iran,2,2,Friendly,Croatia,28,5,2006,0,0,4,3070,0,1,Croatia,Iran,6,0,0.13176,0.12769,11,draw,draw
Germany,Japan,2,2,Friendly,Germany,30,5,2006,0,0,4,3071,1,0,Germany,Japan,6,0,0.14782,0.94729,11,draw,draw
France,Denmark,2,0,Friendly,France,31,5,2006,2,-2,2,3072,0,1,France,Denmark,6,2,0.9046,0.22063,11,winner,loser
Netherlands,Mexico,2,1,Friendly,Netherlands,1,6,2006,1,-1,3,3073,1,1,Netherlands,Mexico,6,1,0.41746,0.36883,11,winner,loser
Tunisia,Uruguay,0,0,Friendly,Tunisia,2,6,2006,0,0,0,3074,1,1,Tunisia,Uruguay,6,0,0.38721,0.43757,11,draw,draw
Croatia,Poland,0,1,Friendly,Germany,3,6,2006,-1,1,1,3075,0,0,Croatia,Poland,6,1,0.05725,0.15728,11,loser,winner
Ghana,South Korea,3,1,Friendly,Scotland,4,6,2006,2,-2,4,3076,0,0,Ghana,South_Korea,6,2,0.73219,0.70553,11,winner,loser
Netherlands,Australia,1,1,Friendly,Netherlands,4,6,2006,0,0,2,3077,1,0,Netherlands,Australia,6,0,0.89995,0.25847,11,draw,draw
Spain,Croatia,2,1,Friendly,Switzerland,7,6,2006,1,-1,3,3078,1,0,Spain,Croatia,6,1,0.67142,0.09581,11,winner,loser
Germany,Costa Rica,4,2,FIFA World Cup,Germany,9,6,2006,2,-2,6,3079,1,1,Germany,Costa_Rica,6,2,0.94341,0.34841,11,winner,loser
Poland,Ecuador,0,2,FIFA World Cup,Germany,9,6,2006,-2,2,2,3080,0,0,Poland,Ecuador,6,2,0.60821,0.67592,11,loser,winner
Mexico,Iran,3,1,FIFA World Cup,Germany,11,6,2006,2,-2,4,3081,1,1,Mexico,Iran,6,2,0.54661,0.66325,11,winner,loser
Serbia,Netherlands,0,1,FIFA World Cup,Germany,11,6,2006,-1,1,1,3082,1,1,Serbia,Netherlands,6,1,0.1161,0.13378,11,loser,winner
Australia,Japan,3,1,FIFA World Cup,Germany,12,6,2006,2,-2,4,3083,0,0,Australia,Japan,6,2,0.52483,0.7237,11,winner,loser
Brazil,Croatia,1,0,FIFA World Cup,Germany,13,6,2006,1,-1,1,3084,0,0,Brazil,Croatia,6,1,0.18734,0.30565,11,winner,loser
France,Switzerland,0,0,FIFA World Cup,Germany,13,6,2006,0,0,0,3085,0,0,France,Switzerland,6,0,0.65727,0.30536,11,draw,draw
Germany,Poland,1,0,FIFA World Cup,Germany,14,6,2006,1,-1,1,3086,1,0,Germany,Poland,6,1,0.59797,0.70573,11,winner,loser
Tunisia,Saudi Arabia,2,2,FIFA World Cup,Germany,14,6,2006,0,0,4,3087,1,1,Tunisia,Saudi_Arabia,6,0,0.71998,0.30048,11,draw,draw
Ecuador,Costa Rica,3,0,FIFA World Cup,Germany,15,6,2006,3,-3,3,3088,0,1,Ecuador,Costa_Rica,6,3,0.65888,0.2909,11,winner,loser
Argentina,Serbia,6,0,FIFA World Cup,Germany,16,6,2006,6,-6,6,3089,1,1,Argentina,Serbia,6,6,0.21656,0.34941,11,winner,loser
Portugal,Iran,2,0,FIFA World Cup,Germany,17,6,2006,2,-2,2,3090,1,1,Portugal,Iran,6,2,0.79449,0.82589,11,winner,loser
Brazil,Australia,2,0,FIFA World Cup,Germany,18,6,2006,2,-2,2,3091,0,0,Brazil,Australia,6,2,0.59896,0.44373,11,winner,loser
France,South Korea,1,1,FIFA World Cup,Germany,18,6,2006,0,0,2,3092,0,0,France,South_Korea,6,0,0.59457,0.30194,11,draw,draw
Japan,Croatia,0,0,FIFA World Cup,Germany,18,6,2006,0,0,0,3093,0,0,Japan,Croatia,6,0,0.56104,0.53586,11,draw,draw
Spain,Tunisia,3,1,FIFA World Cup,Germany,19,6,2006,2,-2,4,3094,1,1,Spain,Tunisia,6,2,0.60309,0.65011,11,winner,loser
Costa Rica,Poland,1,2,FIFA World Cup,Germany,20,6,2006,-1,1,3,3095,1,0,Costa_Rica,Poland,6,1,0.24241,0.73259,11,loser,winner
Germany,Ecuador,3,0,FIFA World Cup,Germany,20,6,2006,3,-3,3,3096,1,0,Germany,Ecuador,6,3,0.05154,0.8476,11,winner,loser
Netherlands,Argentina,0,0,FIFA World Cup,Germany,21,6,2006,0,0,0,3097,1,1,Netherlands,Argentina,6,0,0.98758,0.60581,11,draw,draw
Portugal,Mexico,2,1,FIFA World Cup,Germany,21,6,2006,1,-1,3,3098,1,1,Portugal,Mexico,6,1,0.57763,0.09761,11,winner,loser
Croatia,Australia,2,2,FIFA World Cup,Germany,22,6,2006,0,0,4,3099,0,0,Croatia,Australia,6,0,0.51781,0.28194,11,draw,draw
Ghana,United States,2,1,FIFA World Cup,Germany,22,6,2006,1,-1,3,3100,0,0,Ghana,United_States,6,1,0.53547,0.48636,11,winner,loser
Japan,Brazil,1,4,FIFA World Cup,Germany,22,6,2006,-3,3,5,3101,0,0,Japan,Brazil,6,3,0.2484,0.30435,11,loser,winner
Saudi Arabia,Spain,0,1,FIFA World Cup,Germany,23,6,2006,-1,1,1,3102,1,1,Saudi_Arabia,Spain,6,1,0.66549,0.93455,11,loser,winner
Switzerland,South Korea,2,0,FIFA World Cup,Germany,23,6,2006,2,-2,2,3103,0,0,Switzerland,South_Korea,6,2,0.24928,0.01319,11,winner,loser
Argentina,Mexico,2,1,FIFA World Cup,Germany,24,6,2006,1,-1,3,3104,1,1,Argentina,Mexico,6,1,0.48961,0.51623,11,winner,loser
England,Ecuador,1,0,FIFA World Cup,Germany,25,6,2006,1,-1,1,3105,1,0,England,Ecuador,6,1,0.65684,0.43204,11,winner,loser
Portugal,Netherlands,1,0,FIFA World Cup,Germany,25,6,2006,1,-1,1,3106,1,1,Portugal,Netherlands,6,1,0.0595,0.56405,11,winner,loser
Brazil,Ghana,3,0,FIFA World Cup,Germany,27,6,2006,3,-3,3,3107,0,0,Brazil,Ghana,6,3,0.33092,0.82306,11,winner,loser
Spain,France,1,3,FIFA World Cup,Germany,27,6,2006,-2,2,4,3108,1,0,Spain,France,6,2,0.82189,0.16449,11,loser,winner
Germany,Argentina,1,1,FIFA World Cup,Germany,30,6,2006,0,0,2,3109,1,1,Germany,Argentina,6,0,0.96747,0.93881,11,draw,draw
Brazil,France,0,1,FIFA World Cup,Germany,1,7,2006,-1,1,1,3110,0,0,Brazil,France,6,1,0.77396,0.05017,11,loser,winner
England,Portugal,0,0,FIFA World Cup,Germany,1,7,2006,0,0,0,3111,1,1,England,Portugal,6,0,0.20029,0.04392,11,draw,draw
Portugal,France,0,1,FIFA World Cup,Germany,5,7,2006,-1,1,1,3112,1,0,Portugal,France,6,1,0.54539,0.08888,11,loser,winner
Germany,Portugal,3,1,FIFA World Cup,Germany,8,7,2006,2,-2,4,3113,1,1,Germany,Portugal,6,2,0.74522,0.42531,11,winner,loser
Denmark,Poland,2,0,Friendly,Denmark,16,8,2006,2,-2,2,3114,1,0,Denmark,Poland,6,2,0.20663,0.65947,11,winner,loser
Denmark,Portugal,4,2,Friendly,Denmark,1,9,2006,2,-2,6,3115,1,1,Denmark,Portugal,6,2,0.8245,0.49963,11,winner,loser
South Korea,Iran,1,1,AFC Asian Cup qualification,South Korea,2,9,2006,0,0,2,3116,0,1,South_Korea,Iran,6,0,0.77869,0.28576,11,draw,draw
Argentina,Brazil,0,3,Friendly,England,3,9,2006,-3,3,3,3117,1,0,Argentina,Brazil,6,3,0.65765,0.67143,11,loser,winner
Saudi Arabia,Japan,1,0,AFC Asian Cup qualification,Saudi Arabia,3,9,2006,1,-1,1,3118,1,0,Saudi_Arabia,Japan,6,1,0.73795,0.18676,11,winner,loser
Wales,Brazil,0,2,Friendly,England,5,9,2006,-2,2,2,3119,0,0,Wales,Brazil,6,2,0.83991,0.75957,11,loser,winner
Poland,Serbia,1,1,UEFA Euro qualification,Poland,6,9,2006,0,0,2,3120,0,1,Poland,Serbia,6,0,0.51592,0.99307,11,draw,draw
Switzerland,Costa Rica,2,0,Friendly,Switzerland,6,9,2006,2,-2,2,3121,0,1,Switzerland,Costa_Rica,6,2,0.36539,0.75259,11,winner,loser
Japan,Ghana,0,1,Friendly,Japan,4,10,2006,-1,1,1,3122,0,0,Japan,Ghana,6,1,0.61069,0.46943,11,loser,winner
Serbia,Belgium,1,0,UEFA Euro qualification,Serbia,7,10,2006,1,-1,1,3123,1,1,Serbia,Belgium,6,1,0.95663,0.45997,11,winner,loser
South Korea,Ghana,1,3,Friendly,South Korea,8,10,2006,-2,2,4,3124,0,0,South_Korea,Ghana,6,2,0.04035,0.38297,11,loser,winner
Brazil,Ecuador,2,1,Friendly,Sweden,10,10,2006,1,-1,3,3125,0,0,Brazil,Ecuador,6,1,0.36804,0.01123,11,winner,loser
Croatia,England,2,0,UEFA Euro qualification,Croatia,11,10,2006,2,-2,2,3126,0,1,Croatia,England,6,2,0.5532,0.7935,11,winner,loser
Poland,Portugal,2,1,UEFA Euro qualification,Poland,11,10,2006,1,-1,3,3127,0,1,Poland,Portugal,6,1,0.40583,0.17871,11,winner,loser
Spain,Argentina,2,1,Friendly,Spain,11,10,2006,1,-1,3,3128,1,1,Spain,Argentina,6,1,0.39141,0.46166,11,winner,loser
Australia,Ghana,1,1,Friendly,England,14,11,2006,0,0,2,3129,0,0,Australia,Ghana,6,0,0.13314,0.2219,11,draw,draw
Belgium,Poland,0,1,UEFA Euro qualification,Belgium,15,11,2006,-1,1,1,3130,1,0,Belgium,Poland,6,1,0.19616,0.54672,11,loser,winner
Iran,South Korea,2,0,AFC Asian Cup qualification,Iran,15,11,2006,2,-2,2,3131,1,0,Iran,South_Korea,6,2,0.40917,0.4244,11,winner,loser
Japan,Saudi Arabia,3,1,AFC Asian Cup qualification,Japan,15,11,2006,2,-2,4,3132,0,1,Japan,Saudi_Arabia,6,2,0.78643,0.81342,11,winner,loser
Netherlands,England,1,1,Friendly,Netherlands,15,11,2006,0,0,2,3133,1,1,Netherlands,England,6,0,0.83709,0.56033,11,draw,draw
Switzerland,Brazil,1,2,Friendly,Switzerland,15,11,2006,-1,1,3,3134,0,0,Switzerland,Brazil,6,1,0.53406,0.15678,11,loser,winner
Saudi Arabia,Qatar,1,1,Gulf Cup,United Arab Emirates,21,1,2007,0,0,2,3135,1,0,Saudi_Arabia,Qatar,7,0,0.09961,0.65669,11,draw,draw
Australia,Denmark,1,3,Friendly,England,6,2,2007,-2,2,4,3136,0,1,Australia,Denmark,7,2,0.49842,0.79528,11,loser,winner
Portugal,Brazil,2,0,Friendly,England,6,2,2007,2,-2,2,3137,1,0,Portugal,Brazil,7,2,0.35729,0.34655,11,winner,loser
England,Spain,0,1,Friendly,England,7,2,2007,-1,1,1,3138,1,1,England,Spain,7,1,0.27838,0.19618,11,loser,winner
France,Argentina,0,1,Friendly,France,7,2,2007,-1,1,1,3139,0,1,France,Argentina,7,1,0.6701,0.93986,11,loser,winner
Germany,Switzerland,3,1,Friendly,Germany,7,2,2007,2,-2,4,3140,1,0,Germany,Switzerland,7,2,0.28738,0.07381,11,winner,loser
Morocco,Tunisia,1,1,Friendly,Morocco,7,2,2007,0,0,2,3141,0,1,Morocco,Tunisia,7,0,0.57983,0.92648,11,draw,draw
United States,Mexico,2,0,Friendly,United States,7,2,2007,2,-2,2,3142,0,1,United_States,Mexico,7,2,0.99557,0.5184,11,winner,loser
South Korea,Uruguay,0,2,Friendly,South Korea,24,3,2007,-2,2,2,3143,0,1,South_Korea,Uruguay,7,2,0.86934,0.05513,11,loser,winner
Portugal,Belgium,4,0,UEFA Euro qualification,Portugal,24,3,2007,4,-4,4,3144,1,1,Portugal,Belgium,7,4,0.98047,0.87831,11,winner,loser
Qatar,Iran,0,1,Friendly,Qatar,24,3,2007,-1,1,1,3145,0,1,Qatar,Iran,7,1,0.94037,0.38448,11,loser,winner
Spain,Denmark,2,1,UEFA Euro qualification,Spain,24,3,2007,1,-1,3,3146,1,1,Spain,Denmark,7,1,0.59588,0.03942,11,winner,loser
United States,Ecuador,3,1,Friendly,United States,25,3,2007,2,-2,4,3147,0,0,United_States,Ecuador,7,2,0.44483,0.48265,11,winner,loser
Brazil,Ghana,1,0,Friendly,Sweden,27,3,2007,1,-1,1,3148,0,0,Brazil,Ghana,7,1,0.20434,0.11554,11,winner,loser
Germany,Denmark,0,1,Friendly,Germany,28,3,2007,-1,1,1,3149,1,1,Germany,Denmark,7,1,0.7014,0.89646,11,loser,winner
Mexico,Ecuador,4,2,Friendly,United States,28,3,2007,2,-2,6,3150,1,0,Mexico,Ecuador,7,2,0.13599,0.16897,11,winner,loser
Serbia,Portugal,1,1,UEFA Euro qualification,Serbia,28,3,2007,0,0,2,3151,1,1,Serbia,Portugal,7,0,0.58548,0.66054,11,draw,draw
England,Brazil,1,1,Friendly,England,1,6,2007,0,0,2,3152,1,0,England,Brazil,7,0,0.33845,0.45659,11,draw,draw
Australia,Uruguay,1,2,Friendly,Australia,2,6,2007,-1,1,3,3153,0,1,Australia,Uruguay,7,1,0.43974,0.93203,11,loser,winner
Belgium,Portugal,1,2,UEFA Euro qualification,Belgium,2,6,2007,-1,1,3,3154,1,1,Belgium,Portugal,7,1,0.59397,0.1758,11,loser,winner
South Korea,Netherlands,0,2,Friendly,South Korea,2,6,2007,-2,2,2,3155,0,1,South_Korea,Netherlands,7,2,0.72051,0.47873,11,loser,winner
Mexico,Iran,4,0,Friendly,Mexico,2,6,2007,4,-4,4,3156,1,1,Mexico,Iran,7,4,0.7311,0.3467,11,winner,loser
Switzerland,Argentina,1,1,Friendly,Switzerland,2,6,2007,0,0,2,3157,0,1,Switzerland,Argentina,7,0,0.21864,0.52013,11,draw,draw
Costa Rica,Canada,1,2,Gold Cup,United States,6,6,2007,-1,1,3,3158,1,0,Costa_Rica,Canada,7,1,0.82005,0.47569,11,loser,winner
Mexico,Costa Rica,1,0,Gold Cup,United States,17,6,2007,1,-1,1,3159,1,1,Mexico,Costa_Rica,7,1,0.05167,0.93826,11,winner,loser
United States,Canada,2,1,Gold Cup,United States,21,6,2007,1,-1,3,3160,0,0,United_States,Canada,7,1,0.9502,0.01494,11,winner,loser
United States,Mexico,2,1,Gold Cup,United States,24,6,2007,1,-1,3,3161,0,1,United_States,Mexico,7,1,0.20795,0.09898,11,winner,loser
Brazil,Mexico,0,2,Copa America,Venezuela,27,6,2007,-2,2,2,3162,0,1,Brazil,Mexico,7,2,0.80171,0.29534,11,loser,winner
Argentina,United States,4,1,Copa America,Venezuela,28,6,2007,3,-3,5,3163,1,0,Argentina,United_States,7,3,0.34312,0.95467,11,winner,loser
Mexico,Ecuador,2,1,Copa America,Venezuela,1,7,2007,1,-1,3,3164,1,0,Mexico,Ecuador,7,1,0.54781,0.95828,11,winner,loser
Brazil,Ecuador,1,0,Copa America,Venezuela,4,7,2007,1,-1,1,3165,0,0,Brazil,Ecuador,7,1,0.0812,0.59765,11,winner,loser
Japan,Qatar,1,1,AFC Asian Cup,Vietnam,9,7,2007,0,0,2,3166,0,0,Japan,Qatar,7,0,0.04681,0.37206,11,draw,draw
Uruguay,Brazil,2,2,Copa America,Venezuela,10,7,2007,0,0,4,3167,1,0,Uruguay,Brazil,7,0,0.59092,0.37752,11,draw,draw
South Korea,Saudi Arabia,1,1,AFC Asian Cup,Indonesia,11,7,2007,0,0,2,3168,0,1,South_Korea,Saudi_Arabia,7,0,0.13675,0.98007,11,draw,draw
Mexico,Argentina,0,3,Copa America,Venezuela,11,7,2007,-3,3,3,3169,1,1,Mexico,Argentina,7,3,0.52433,0.55231,11,loser,winner
Mexico,Uruguay,3,1,Copa America,Venezuela,14,7,2007,2,-2,4,3170,1,1,Mexico,Uruguay,7,2,0.79077,0.11496,11,winner,loser
Brazil,Argentina,3,0,Copa America,Venezuela,15,7,2007,3,-3,3,3171,0,1,Brazil,Argentina,7,3,0.52079,0.34666,11,winner,loser
Japan,Australia,1,1,AFC Asian Cup,Vietnam,21,7,2007,0,0,2,3172,0,0,Japan,Australia,7,0,0.52376,0.52618,11,draw,draw
Iran,South Korea,0,0,AFC Asian Cup,Malaysia,22,7,2007,0,0,0,3173,1,0,Iran,South_Korea,7,0,0.59149,0.7316,11,draw,draw
Japan,Saudi Arabia,2,3,AFC Asian Cup,Vietnam,25,7,2007,-1,1,5,3174,0,1,Japan,Saudi_Arabia,7,1,0.28489,0.96288,11,loser,winner
South Korea,Japan,0,0,AFC Asian Cup,Indonesia,28,7,2007,0,0,0,3175,0,0,South_Korea,Japan,7,0,0.48024,0.12691,11,draw,draw
Ghana,Senegal,1,1,Friendly,England,21,8,2007,0,0,2,3176,0,0,Ghana,Senegal,7,0,0.63122,0.85436,11,draw,draw
Belgium,Serbia,3,2,UEFA Euro qualification,Belgium,22,8,2007,1,-1,5,3177,1,1,Belgium,Serbia,7,1,0.75445,0.70156,11,winner,loser
England,Germany,1,2,Friendly,England,22,8,2007,-1,1,3,3178,1,1,England,Germany,7,1,0.82079,0.80112,11,loser,winner
Japan,Cameroon,2,0,Friendly,Japan,22,8,2007,2,-2,2,3179,0,1,Japan,Cameroon,7,2,0.68414,0.67035,11,winner,loser
Switzerland,Netherlands,2,1,Friendly,Switzerland,22,8,2007,1,-1,3,3180,0,1,Switzerland,Netherlands,7,1,0.63322,0.9136,11,winner,loser
Morocco,Ghana,0,2,Friendly,France,8,9,2007,-2,2,2,3181,0,0,Morocco,Ghana,7,2,0.09276,0.63862,11,loser,winner
Portugal,Poland,2,2,UEFA Euro qualification,Portugal,8,9,2007,0,0,4,3182,1,0,Portugal,Poland,7,0,0.81636,0.63015,11,draw,draw
Wales,Germany,0,2,UEFA Euro qualification,Wales,8,9,2007,-2,2,2,3183,0,1,Wales,Germany,7,2,0.80099,0.16517,11,loser,winner
United States,Brazil,2,4,Friendly,United States,9,9,2007,-2,2,6,3184,0,0,United_States,Brazil,7,2,0.24218,0.17109,11,loser,winner
Australia,Argentina,0,1,Friendly,Australia,11,9,2007,-1,1,1,3185,0,1,Australia,Argentina,7,1,0.74868,0.84476,11,loser,winner
Saudi Arabia,Ghana,5,0,Friendly,Saudi Arabia,11,9,2007,5,-5,5,3186,1,0,Saudi_Arabia,Ghana,7,5,0.52027,0.44594,11,winner,loser
Switzerland,Japan,3,4,Friendly,Austria,11,9,2007,-1,1,7,3187,0,0,Switzerland,Japan,7,1,0.33283,0.05622,11,loser,winner
Canada,Costa Rica,1,1,Friendly,Canada,12,9,2007,0,0,2,3188,0,1,Canada,Costa_Rica,7,0,0.23207,0.78636,11,draw,draw
Mexico,Brazil,1,3,Friendly,United States,12,9,2007,-2,2,4,3189,1,0,Mexico,Brazil,7,2,0.88526,0.98489,11,loser,winner
Portugal,Serbia,1,1,UEFA Euro qualification,Portugal,12,9,2007,0,0,2,3190,1,1,Portugal,Serbia,7,0,0.59717,0.04491,11,draw,draw
Denmark,Spain,1,3,UEFA Euro qualification,Denmark,13,10,2007,-2,2,4,3191,1,1,Denmark,Spain,7,2,0.57184,0.11232,11,loser,winner
Brazil,Ecuador,5,0,FIFA World Cup qualification,Brazil,17,10,2007,5,-5,5,3192,0,0,Brazil,Ecuador,7,5,0.74717,0.62723,11,winner,loser
Switzerland,United States,0,1,Friendly,Switzerland,17,10,2007,-1,1,1,3193,0,0,Switzerland,United_States,7,1,0.6415,0.69825,11,loser,winner
France,Morocco,2,2,Friendly,France,16,11,2007,0,0,4,3194,0,0,France,Morocco,7,0,0.01318,0.83209,11,draw,draw
Poland,Belgium,2,0,UEFA Euro qualification,Poland,17,11,2007,2,-2,2,3195,0,1,Poland,Belgium,7,2,0.21453,0.6123,11,winner,loser
Brazil,Uruguay,2,1,FIFA World Cup qualification,Brazil,21,11,2007,1,-1,3,3196,0,1,Brazil,Uruguay,7,1,0.38945,0.14552,11,winner,loser
England,Croatia,2,3,UEFA Euro qualification,England,21,11,2007,-1,1,5,3197,1,0,England,Croatia,7,1,0.89665,0.21969,11,loser,winner
Germany,Wales,0,0,UEFA Euro qualification,Germany,21,11,2007,0,0,0,3198,1,0,Germany,Wales,7,0,0.59569,0.18606,11,draw,draw
Morocco,Senegal,3,0,Friendly,France,21,11,2007,3,-3,3,3199,0,0,Morocco,Senegal,7,3,0.67509,0.22924,11,winner,loser
Serbia,Poland,2,2,UEFA Euro qualification,Serbia,21,11,2007,0,0,4,3200,1,0,Serbia,Poland,7,0,0.03333,0.23,11,draw,draw
Qatar,Iran,0,0,Friendly,Qatar,10,1,2008,0,0,0,3201,0,1,Qatar,Iran,8,0,0.53246,0.1404,11,draw,draw
Tunisia,Senegal,2,2,African Cup of Nations,Ghana,23,1,2008,0,0,4,3202,1,0,Tunisia,Senegal,8,0,0.04872,0.02365,11,draw,draw
Ghana,Morocco,2,0,African Cup of Nations,Ghana,28,1,2008,2,-2,2,3203,0,0,Ghana,Morocco,8,2,0.80158,0.76379,11,winner,loser
Iran,Costa Rica,0,0,Friendly,Iran,30,1,2008,0,0,0,3204,1,1,Iran,Costa_Rica,8,0,0.19361,0.62823,11,draw,draw
Tunisia,Cameroon,2,3,African Cup of Nations,Ghana,4,2,2008,-1,1,5,3205,1,1,Tunisia,Cameroon,8,1,0.43002,0.00708,11,loser,winner
Australia,Qatar,3,0,FIFA World Cup qualification,Australia,6,2,2008,3,-3,3,3206,0,0,Australia,Qatar,8,3,0.22511,0.38097,11,winner,loser
Croatia,Netherlands,0,3,Friendly,Croatia,6,2,2008,-3,3,3,3207,0,1,Croatia,Netherlands,8,3,0.6024,0.62797,11,loser,winner
England,Switzerland,2,1,Friendly,England,6,2,2008,1,-1,3,3208,1,0,England,Switzerland,8,1,0.93149,0.90988,11,winner,loser
Spain,France,1,0,Friendly,Spain,6,2,2008,1,-1,1,3209,1,0,Spain,France,8,1,0.10092,0.76411,11,winner,loser
United States,Mexico,2,2,Friendly,United States,6,2,2008,0,0,4,3210,0,1,United_States,Mexico,8,0,0.22353,0.64812,11,draw,draw
Ghana,Cameroon,0,1,African Cup of Nations,Ghana,7,2,2008,-1,1,1,3211,0,1,Ghana,Cameroon,8,1,0.63258,0.75585,11,loser,winner
Japan,South Korea,1,1,EAFF Championship,China PR,23,2,2008,0,0,2,3212,0,0,Japan,South_Korea,8,0,0.05139,0.63716,11,draw,draw
Belgium,Morocco,1,4,Friendly,Belgium,26,3,2008,-3,3,5,3213,1,0,Belgium,Morocco,8,3,0.30228,0.52198,11,loser,winner
France,England,1,0,Friendly,France,26,3,2008,1,-1,1,3214,0,1,France,England,8,1,0.64732,0.39956,11,winner,loser
Ghana,Mexico,1,2,Friendly,England,26,3,2008,-1,1,3,3215,0,1,Ghana,Mexico,8,1,0.37206,0.77835,11,loser,winner
Poland,United States,0,3,Friendly,Poland,26,3,2008,-3,3,3,3216,0,0,Poland,United_States,8,3,0.3833,0.97746,11,loser,winner
Switzerland,Germany,0,4,Friendly,Switzerland,26,3,2008,-4,4,4,3217,0,1,Switzerland,Germany,8,4,0.69812,0.48912,11,loser,winner
Australia,Ghana,1,0,Friendly,Australia,23,5,2008,1,-1,1,3218,0,0,Australia,Ghana,8,1,0.55844,0.1761,11,winner,loser
France,Ecuador,2,0,Friendly,France,27,5,2008,2,-2,2,3219,0,0,France,Ecuador,8,2,0.72839,0.25108,11,winner,loser
England,United States,2,0,Friendly,England,28,5,2008,2,-2,2,3220,1,0,England,United_States,8,2,0.14193,0.82831,11,winner,loser
Netherlands,Denmark,1,1,Friendly,Netherlands,29,5,2008,0,0,2,3221,1,1,Netherlands,Denmark,8,0,0.85828,0.9344,11,draw,draw
Brazil,Canada,3,2,Friendly,United States,31,5,2008,1,-1,5,3222,0,0,Brazil,Canada,8,1,0.0479,0.82258,11,winner,loser
Germany,Serbia,2,1,Friendly,Germany,31,5,2008,1,-1,3,3223,1,1,Germany,Serbia,8,1,0.92701,0.66123,11,winner,loser
Netherlands,Wales,2,0,Friendly,Netherlands,1,6,2008,2,-2,2,3224,1,0,Netherlands,Wales,8,2,0.77244,0.72077,11,winner,loser
Poland,Denmark,1,1,Friendly,Poland,1,6,2008,0,0,2,3225,0,1,Poland,Denmark,8,0,0.40924,0.94843,11,draw,draw
Mexico,Argentina,1,4,Friendly,United States,4,6,2008,-3,3,5,3226,1,1,Mexico,Argentina,8,3,0.88404,0.73692,11,loser,winner
Spain,United States,1,0,Friendly,Spain,4,6,2008,1,-1,1,3227,1,0,Spain,United_States,8,1,0.5177,0.58066,11,winner,loser
Germany,Poland,2,0,UEFA Euro,Austria,8,6,2008,2,-2,2,3228,1,0,Germany,Poland,8,2,0.68719,0.34261,11,winner,loser
United States,Argentina,0,0,Friendly,United States,8,6,2008,0,0,0,3229,0,1,United_States,Argentina,8,0,0.54877,0.41566,11,draw,draw
Croatia,Germany,2,1,UEFA Euro,Austria,12,6,2008,1,-1,3,3230,0,1,Croatia,Germany,8,1,0.41698,0.9148,11,winner,loser
Netherlands,France,4,1,UEFA Euro,Switzerland,13,6,2008,3,-3,5,3231,1,0,Netherlands,France,8,3,0.81299,0.89401,11,winner,loser
Qatar,Australia,1,3,FIFA World Cup qualification,Qatar,14,6,2008,-2,2,4,3232,0,0,Qatar,Australia,8,2,0.23341,0.64595,11,loser,winner
Argentina,Ecuador,1,1,FIFA World Cup qualification,Argentina,15,6,2008,0,0,2,3233,1,0,Argentina,Ecuador,8,0,0.82033,0.09868,11,draw,draw
Switzerland,Portugal,2,0,UEFA Euro,Switzerland,15,6,2008,2,-2,2,3234,0,1,Switzerland,Portugal,8,2,0.72145,0.84591,11,winner,loser
Poland,Croatia,0,1,UEFA Euro,Austria,16,6,2008,-1,1,1,3235,0,0,Poland,Croatia,8,1,0.11377,0.49235,11,loser,winner
Brazil,Argentina,0,0,FIFA World Cup qualification,Brazil,18,6,2008,0,0,0,3236,0,1,Brazil,Argentina,8,0,0.64491,0.67964,11,draw,draw
Portugal,Germany,2,3,UEFA Euro,Switzerland,19,6,2008,-1,1,5,3237,1,1,Portugal,Germany,8,1,0.83747,0.80997,11,loser,winner
Germany,Spain,0,1,UEFA Euro,Austria,29,6,2008,-1,1,1,3238,1,1,Germany,Spain,8,1,0.55577,0.88155,11,loser,winner
Iran,Qatar,6,1,WAFF Championship,Iran,11,8,2008,5,-5,7,3239,1,0,Iran,Qatar,8,5,0.69519,0.03607,11,winner,loser
Denmark,Spain,0,3,Friendly,Denmark,20,8,2008,-3,3,3,3240,1,1,Denmark,Spain,8,3,0.22059,0.78463,11,loser,winner
Germany,Belgium,2,0,Friendly,Germany,20,8,2008,2,-2,2,3241,1,1,Germany,Belgium,8,2,0.42863,0.66595,11,winner,loser
Japan,Uruguay,1,3,Friendly,Japan,20,8,2008,-2,2,4,3242,0,1,Japan,Uruguay,8,2,0.86928,0.80435,11,loser,winner
Saudi Arabia,Qatar,2,1,Friendly,Saudi Arabia,30,8,2008,1,-1,3,3243,1,0,Saudi_Arabia,Qatar,8,1,0.09464,0.18105,11,winner,loser
Netherlands,Australia,1,2,Friendly,Netherlands,6,9,2008,-1,1,3,3244,1,0,Netherlands,Australia,8,1,0.30839,0.16009,11,loser,winner
Saudi Arabia,Iran,1,1,FIFA World Cup qualification,Saudi Arabia,6,9,2008,0,0,2,3245,1,1,Saudi_Arabia,Iran,8,0,0.07333,0.44562,11,draw,draw
Croatia,England,1,4,FIFA World Cup qualification,Croatia,10,9,2008,-3,3,5,3246,0,1,Croatia,England,8,3,0.92807,0.80425,11,loser,winner
France,Serbia,2,1,FIFA World Cup qualification,France,10,9,2008,1,-1,3,3247,0,1,France,Serbia,8,1,0.66387,0.62148,11,winner,loser
Mexico,Canada,2,1,FIFA World Cup qualification,Mexico,10,9,2008,1,-1,3,3248,1,0,Mexico,Canada,8,1,0.94837,0.43313,11,winner,loser
Portugal,Denmark,2,3,FIFA World Cup qualification,Portugal,10,9,2008,-1,1,5,3249,1,1,Portugal,Denmark,8,1,0.69395,0.02033,11,loser,winner
Uruguay,Ecuador,0,0,FIFA World Cup qualification,Uruguay,10,9,2008,0,0,0,3250,1,0,Uruguay,Ecuador,8,0,0.05673,0.28585,11,draw,draw
Argentina,Uruguay,2,1,FIFA World Cup qualification,Argentina,11,10,2008,1,-1,3,3251,1,1,Argentina,Uruguay,8,1,0.08143,0.70541,11,winner,loser
France,Tunisia,3,1,Friendly,France,14,10,2008,2,-2,4,3252,0,1,France,Tunisia,8,2,0.57609,0.65078,11,winner,loser
Australia,Qatar,4,0,FIFA World Cup qualification,Australia,15,10,2008,4,-4,4,3253,0,0,Australia,Qatar,8,4,0.88299,0.11653,11,winner,loser
Belgium,Spain,1,2,FIFA World Cup qualification,Belgium,15,10,2008,-1,1,3,3254,1,1,Belgium,Spain,8,1,0.47457,0.19247,11,loser,winner
Canada,Mexico,2,2,FIFA World Cup qualification,Canada,15,10,2008,0,0,4,3255,0,1,Canada,Mexico,8,0,0.74431,0.62105,11,draw,draw
Germany,Wales,1,0,FIFA World Cup qualification,Germany,15,10,2008,1,-1,1,3256,1,0,Germany,Wales,8,1,0.84313,0.74399,11,winner,loser
Qatar,Iran,0,1,Friendly,Qatar,9,11,2008,-1,1,1,3257,0,1,Qatar,Iran,8,1,0.85947,0.5747,11,loser,winner
Mexico,Ecuador,2,1,Friendly,United States,12,11,2008,1,-1,3,3258,1,0,Mexico,Ecuador,8,1,0.146,0.89627,11,winner,loser
Brazil,Portugal,6,2,Friendly,Brazil,19,11,2008,4,-4,8,3259,0,1,Brazil,Portugal,8,4,0.71718,0.65265,11,winner,loser
Denmark,Wales,0,1,Friendly,Denmark,19,11,2008,-1,1,1,3260,1,0,Denmark,Wales,8,1,0.11877,0.97773,11,loser,winner
France,Uruguay,0,0,Friendly,France,19,11,2008,0,0,0,3261,0,1,France,Uruguay,8,0,0.19827,0.47878,11,draw,draw
Germany,England,1,2,Friendly,Germany,19,11,2008,-1,1,3,3262,1,1,Germany,England,8,1,0.40481,0.85531,11,loser,winner
Ghana,Tunisia,0,0,Friendly,Ghana,19,11,2008,0,0,0,3263,0,1,Ghana,Tunisia,8,0,0.69021,0.03158,11,draw,draw
Qatar,Japan,0,3,FIFA World Cup qualification,Qatar,19,11,2008,-3,3,3,3264,0,0,Qatar,Japan,8,3,0.86689,0.34817,11,loser,winner
Saudi Arabia,South Korea,0,2,FIFA World Cup qualification,Saudi Arabia,19,11,2008,-2,2,2,3265,1,0,Saudi_Arabia,South_Korea,8,2,0.044,0.2513,11,loser,winner
Serbia,Poland,0,1,Friendly,Turkey,14,12,2008,-1,1,1,3266,1,0,Serbia,Poland,8,1,0.57222,0.81052,11,loser,winner
Iran,Ecuador,0,1,Friendly,Oman,17,12,2008,-1,1,1,3267,1,0,Iran,Ecuador,8,1,0.02291,0.72933,11,loser,winner
Saudi Arabia,Qatar,0,0,Gulf Cup,Oman,5,1,2009,0,0,0,3268,1,0,Saudi_Arabia,Qatar,9,0,0.71108,0.79031,11,draw,draw
France,Argentina,0,2,Friendly,France,11,2,2009,-2,2,2,3269,0,1,France,Argentina,9,2,0.3183,0.23016,11,loser,winner
Iran,South Korea,1,1,FIFA World Cup qualification,Iran,11,2,2009,0,0,2,3270,1,0,Iran,South_Korea,9,0,0.65528,0.61687,11,draw,draw
Japan,Australia,0,0,FIFA World Cup qualification,Japan,11,2,2009,0,0,0,3271,0,0,Japan,Australia,9,0,0.79901,0.88208,11,draw,draw
Spain,England,2,0,Friendly,Spain,11,2,2009,2,-2,2,3272,1,1,Spain,England,9,2,0.97245,0.45515,11,winner,loser
Tunisia,Netherlands,1,1,Friendly,Tunisia,11,2,2009,0,0,2,3273,1,1,Tunisia,Netherlands,9,0,0.05126,0.89023,11,draw,draw
United States,Mexico,2,0,FIFA World Cup qualification,United States,11,2,2009,2,-2,2,3274,0,1,United_States,Mexico,9,2,0.64561,0.22974,11,winner,loser
Wales,Poland,0,1,Friendly,Portugal,11,2,2009,-1,1,1,3275,0,0,Wales,Poland,9,1,0.07162,0.48876,11,loser,winner
Iran,Saudi Arabia,1,2,FIFA World Cup qualification,Iran,28,3,2009,-1,1,3,3276,1,1,Iran,Saudi_Arabia,9,1,0.00894,0.94973,11,loser,winner
Mexico,Costa Rica,2,0,FIFA World Cup qualification,Mexico,28,3,2009,2,-2,2,3277,1,1,Mexico,Costa_Rica,9,2,0.61432,0.99369,11,winner,loser
Ecuador,Brazil,1,1,FIFA World Cup qualification,Ecuador,29,3,2009,0,0,2,3278,0,0,Ecuador,Brazil,9,0,0.59124,0.93943,11,draw,draw
Iran,Senegal,1,1,Friendly,Iran,1,4,2009,0,0,2,3279,1,0,Iran,Senegal,9,0,0.00736,0.82301,11,draw,draw
Wales,Germany,0,2,FIFA World Cup qualification,Wales,1,4,2009,-2,2,2,3280,0,1,Wales,Germany,9,2,0.94571,0.55332,11,loser,winner
Qatar,Saudi Arabia,2,1,Friendly,Qatar,26,5,2009,1,-1,3,3281,0,1,Qatar,Saudi_Arabia,9,1,0.44498,0.86072,11,winner,loser
Japan,Belgium,4,0,Kirin Cup,Japan,31,5,2009,4,-4,4,3282,0,1,Japan,Belgium,9,4,0.13369,0.58948,11,winner,loser
Costa Rica,United States,3,1,FIFA World Cup qualification,Costa Rica,3,6,2009,2,-2,4,3283,1,0,Costa_Rica,United_States,9,2,0.5911,0.59008,11,winner,loser
Qatar,Australia,0,0,FIFA World Cup qualification,Qatar,6,6,2009,0,0,0,3284,0,0,Qatar,Australia,9,0,0.9831,0.4842,11,draw,draw
Uruguay,Brazil,0,4,FIFA World Cup qualification,Uruguay,6,6,2009,-4,4,4,3285,1,0,Uruguay,Brazil,9,4,0.29137,0.88184,11,loser,winner
Ecuador,Argentina,2,0,FIFA World Cup qualification,Ecuador,10,6,2009,2,-2,2,3286,0,1,Ecuador,Argentina,9,2,0.03655,0.36532,11,winner,loser
Japan,Qatar,1,1,FIFA World Cup qualification,Japan,10,6,2009,0,0,2,3287,0,0,Japan,Qatar,9,0,0.28901,0.25616,11,draw,draw
South Korea,Saudi Arabia,0,0,FIFA World Cup qualification,South Korea,10,6,2009,0,0,0,3288,0,1,South_Korea,Saudi_Arabia,9,0,0.37996,0.88559,11,draw,draw
Australia,Japan,2,1,FIFA World Cup qualification,Australia,17,6,2009,1,-1,3,3289,0,0,Australia,Japan,9,1,0.77118,0.5953,11,winner,loser
South Korea,Iran,1,1,FIFA World Cup qualification,South Korea,17,6,2009,0,0,2,3290,0,1,South_Korea,Iran,9,0,0.59429,0.37379,11,draw,draw
United States,Brazil,0,3,Confederations Cup,South Africa,18,6,2009,-3,3,3,3291,0,0,United_States,Brazil,9,3,0.99715,0.12834,11,loser,winner
Spain,United States,0,2,Confederations Cup,South Africa,24,6,2009,-2,2,2,3292,1,0,Spain,United_States,9,2,0.88173,0.95259,11,loser,winner
United States,Brazil,2,3,Confederations Cup,South Africa,28,6,2009,-1,1,5,3293,0,0,United_States,Brazil,9,1,0.07904,0.86,11,loser,winner
Costa Rica,Canada,2,2,Gold Cup,United States,10,7,2009,0,0,4,3294,1,0,Costa_Rica,Canada,9,0,0.90671,0.16525,11,draw,draw
Costa Rica,Mexico,1,1,Gold Cup,United States,23,7,2009,0,0,2,3295,1,1,Costa_Rica,Mexico,9,0,0.94268,0.48549,11,draw,draw
United States,Mexico,0,5,Gold Cup,United States,26,7,2009,-5,5,5,3296,0,1,United_States,Mexico,9,5,0.21808,0.3827,11,loser,winner
Mexico,United States,2,1,FIFA World Cup qualification,Mexico,12,8,2009,1,-1,3,3297,1,0,Mexico,United_States,9,1,0.27195,0.89249,11,winner,loser
Netherlands,England,2,2,Friendly,Netherlands,12,8,2009,0,0,4,3298,1,1,Netherlands,England,9,0,0.96209,0.75056,11,draw,draw
Argentina,Brazil,1,3,FIFA World Cup qualification,Argentina,5,9,2009,-2,2,4,3299,1,0,Argentina,Brazil,9,2,0.85861,0.07926,11,loser,winner
Costa Rica,Mexico,0,3,FIFA World Cup qualification,Costa Rica,5,9,2009,-3,3,3,3300,1,1,Costa_Rica,Mexico,9,3,0.65754,0.59229,11,loser,winner
Denmark,Portugal,1,1,FIFA World Cup qualification,Denmark,5,9,2009,0,0,2,3301,1,1,Denmark,Portugal,9,0,0.06595,0.4435,11,draw,draw
South Korea,Australia,3,1,Friendly,South Korea,5,9,2009,2,-2,4,3302,0,0,South_Korea,Australia,9,2,0.58565,0.89788,11,winner,loser
Netherlands,Japan,3,0,Friendly,Netherlands,5,9,2009,3,-3,3,3303,1,0,Netherlands,Japan,9,3,0.103,0.26842,11,winner,loser
Spain,Belgium,5,0,FIFA World Cup qualification,Spain,5,9,2009,5,-5,5,3304,1,1,Spain,Belgium,9,5,0.61554,0.11225,11,winner,loser
England,Croatia,5,1,FIFA World Cup qualification,England,9,9,2009,4,-4,6,3305,1,0,England,Croatia,9,4,0.71654,0.76912,11,winner,loser
Japan,Ghana,4,3,Friendly,Netherlands,9,9,2009,1,-1,7,3306,0,0,Japan,Ghana,9,1,0.69165,0.83139,11,winner,loser
Serbia,France,1,1,FIFA World Cup qualification,Serbia,9,9,2009,0,0,2,3307,1,0,Serbia,France,9,0,0.25805,0.06298,11,draw,draw
Argentina,Ghana,2,0,Friendly,Argentina,30,9,2009,2,-2,2,3308,1,0,Argentina,Ghana,9,2,0.39483,0.22372,11,winner,loser
Croatia,Qatar,3,2,Friendly,Croatia,8,10,2009,1,-1,5,3309,0,0,Croatia,Qatar,9,1,0.61641,0.43979,11,winner,loser
Australia,Netherlands,0,0,Friendly,Australia,10,10,2009,0,0,0,3310,0,1,Australia,Netherlands,9,0,0.45444,0.11987,11,draw,draw
Ecuador,Uruguay,1,2,FIFA World Cup qualification,Ecuador,10,10,2009,-1,1,3,3311,0,1,Ecuador,Uruguay,9,1,0.28265,0.33814,11,loser,winner
South Korea,Senegal,2,0,Friendly,South Korea,14,10,2009,2,-2,2,3312,0,0,South_Korea,Senegal,9,2,0.32244,0.02348,11,winner,loser
Tunisia,Saudi Arabia,0,1,Friendly,Tunisia,14,10,2009,-1,1,1,3313,1,1,Tunisia,Saudi_Arabia,9,1,0.78062,0.61087,11,loser,winner
Uruguay,Argentina,0,1,FIFA World Cup qualification,Uruguay,14,10,2009,-1,1,1,3314,1,1,Uruguay,Argentina,9,1,0.56121,0.44392,11,loser,winner
United States,Costa Rica,2,2,FIFA World Cup qualification,United States,14,10,2009,0,0,4,3315,0,1,United_States,Costa_Rica,9,0,0.12881,0.84646,11,draw,draw
Brazil,England,1,0,Friendly,Qatar,14,11,2009,1,-1,1,3316,0,1,Brazil,England,9,1,0.09468,0.33746,11,winner,loser
Costa Rica,Uruguay,0,1,FIFA World Cup qualification,Costa Rica,14,11,2009,-1,1,1,3317,1,1,Costa_Rica,Uruguay,9,1,0.48009,0.63676,11,loser,winner
Denmark,South Korea,0,0,Friendly,Denmark,14,11,2009,0,0,0,3318,1,0,Denmark,South_Korea,9,0,0.82682,0.83665,11,draw,draw
Morocco,Cameroon,0,2,FIFA World Cup qualification,Morocco,14,11,2009,-2,2,2,3319,0,1,Morocco,Cameroon,9,2,0.31612,0.62018,11,loser,winner
Spain,Argentina,2,1,Friendly,Spain,14,11,2009,1,-1,3,3320,1,1,Spain,Argentina,9,1,0.38412,0.71468,11,winner,loser
Belgium,Qatar,2,0,Friendly,France,17,11,2009,2,-2,2,3321,1,0,Belgium,Qatar,9,2,0.1999,0.9378,11,winner,loser
Denmark,United States,3,1,Friendly,Denmark,18,11,2009,2,-2,4,3322,1,0,Denmark,United_States,9,2,0.35513,0.59354,11,winner,loser
South Korea,Serbia,0,1,Friendly,England,18,11,2009,-1,1,1,3323,0,1,South_Korea,Serbia,9,1,0.41866,0.06508,11,loser,winner
Poland,Canada,1,0,Friendly,Poland,18,11,2009,1,-1,1,3324,0,0,Poland,Canada,9,1,0.01745,0.82155,11,winner,loser
Uruguay,Costa Rica,1,1,FIFA World Cup qualification,Uruguay,18,11,2009,0,0,2,3325,1,1,Uruguay,Costa_Rica,9,0,0.75997,0.9796,11,draw,draw
Qatar,Iran,3,2,Friendly,Qatar,28,12,2009,1,-1,5,3326,0,1,Qatar,Iran,9,1,0.39732,0.05771,11,winner,loser
Cameroon,Tunisia,2,2,African Cup of Nations,Angola,21,1,2010,0,0,4,3327,1,1,Cameroon,Tunisia,0,0,0.32579,0.19283,12,draw,draw
Argentina,Costa Rica,3,2,Friendly,Argentina,26,1,2010,1,-1,5,3328,1,1,Argentina,Costa_Rica,0,1,0.56414,0.20349,12,winner,loser
Japan,South Korea,1,3,EAFF Championship,Japan,14,2,2010,-2,2,4,3329,0,0,Japan,South_Korea,0,2,0.53189,0.5084,12,loser,winner
Belgium,Croatia,0,1,Friendly,Belgium,3,3,2010,-1,1,1,3330,1,0,Belgium,Croatia,0,1,0.30691,0.32024,12,loser,winner
France,Spain,0,2,Friendly,France,3,3,2010,-2,2,2,3331,0,1,France,Spain,0,2,0.38112,0.33215,12,loser,winner
Germany,Argentina,0,1,Friendly,Germany,3,3,2010,-1,1,1,3332,1,1,Germany,Argentina,0,1,0.07699,0.42732,12,loser,winner
Netherlands,United States,2,1,Friendly,Netherlands,3,3,2010,1,-1,3,3333,1,0,Netherlands,United_States,0,1,0.34805,0.27245,12,winner,loser
Switzerland,Uruguay,1,3,Friendly,Switzerland,3,3,2010,-2,2,4,3334,0,1,Switzerland,Uruguay,0,2,0.11681,0.89136,12,loser,winner
Japan,Serbia,0,3,Friendly,Japan,7,4,2010,-3,3,3,3335,0,1,Japan,Serbia,0,3,0.59424,0.94822,12,loser,winner
Mexico,Ecuador,0,0,Friendly,United States,7,5,2010,0,0,0,3336,1,0,Mexico,Ecuador,0,0,0.55456,0.68458,12,draw,draw
Mexico,Senegal,1,0,Friendly,United States,10,5,2010,1,-1,1,3337,1,0,Mexico,Senegal,0,1,0.89843,0.36857,12,winner,loser
South Korea,Ecuador,2,0,Friendly,South Korea,16,5,2010,2,-2,2,3338,0,0,South_Korea,Ecuador,0,2,4.00E-04,0.88233,12,winner,loser
Croatia,Wales,2,0,Friendly,Croatia,23,5,2010,2,-2,2,3339,0,0,Croatia,Wales,0,2,0.99233,0.0042,12,winner,loser
Argentina,Canada,5,0,Friendly,Argentina,24,5,2010,5,-5,5,3340,1,0,Argentina,Canada,0,5,0.50999,0.14992,12,winner,loser
England,Mexico,3,1,Friendly,England,24,5,2010,2,-2,4,3341,1,1,England,Mexico,0,2,0.03656,0.43818,12,winner,loser
Japan,South Korea,0,2,Friendly,Japan,24,5,2010,-2,2,2,3342,0,0,Japan,South_Korea,0,2,0.124,0.13259,12,loser,winner
France,Costa Rica,2,1,Friendly,France,26,5,2010,1,-1,3,3343,0,1,France,Costa_Rica,0,1,0.07967,0.53131,12,winner,loser
Netherlands,Mexico,2,1,Friendly,Germany,26,5,2010,1,-1,3,3344,1,1,Netherlands,Mexico,0,1,0.33645,0.90607,12,winner,loser
Denmark,Senegal,2,0,Friendly,Denmark,27,5,2010,2,-2,2,3345,1,0,Denmark,Senegal,0,2,0.41733,0.99373,12,winner,loser
Spain,Saudi Arabia,3,2,Friendly,Austria,29,5,2010,1,-1,5,3346,1,1,Spain,Saudi_Arabia,0,1,0.29841,0.96601,12,winner,loser
Japan,England,1,2,Friendly,Austria,30,5,2010,-1,1,3,3347,0,1,Japan,England,0,1,0.83954,0.31874,12,loser,winner
Tunisia,France,1,1,Friendly,Tunisia,30,5,2010,0,0,2,3348,1,0,Tunisia,France,0,0,0.39989,0.48463,12,draw,draw
Australia,Denmark,1,0,Friendly,South Africa,1,6,2010,1,-1,1,3349,0,1,Australia,Denmark,0,1,0.71348,0.64261,12,winner,loser
Netherlands,Ghana,4,1,Friendly,Netherlands,1,6,2010,3,-3,5,3350,1,0,Netherlands,Ghana,0,3,0.99542,0.53116,12,winner,loser
Portugal,Cameroon,3,1,Friendly,Portugal,1,6,2010,2,-2,4,3351,1,1,Portugal,Cameroon,0,2,0.40933,0.88925,12,winner,loser
Switzerland,Costa Rica,0,1,Friendly,Switzerland,1,6,2010,-1,1,1,3352,0,1,Switzerland,Costa_Rica,0,1,0.99777,0.67896,12,loser,winner
Serbia,Poland,0,0,Friendly,Austria,2,6,2010,0,0,0,3353,1,0,Serbia,Poland,0,0,0.00831,0.47557,12,draw,draw
Spain,South Korea,1,0,Friendly,Austria,3,6,2010,1,-1,1,3354,1,0,Spain,South_Korea,0,1,0.02408,0.89466,12,winner,loser
Australia,United States,1,3,Friendly,South Africa,5,6,2010,-2,2,4,3355,0,0,Australia,United_States,0,2,0.18847,0.72228,12,loser,winner
Serbia,Cameroon,4,3,Friendly,Serbia,5,6,2010,1,-1,7,3356,1,1,Serbia,Cameroon,0,1,0.70134,0.75398,12,winner,loser
Spain,Poland,6,0,Friendly,Spain,8,6,2010,6,-6,6,3357,1,0,Spain,Poland,0,6,0.2945,0.04505,12,winner,loser
Uruguay,France,0,0,FIFA World Cup,South Africa,11,6,2010,0,0,0,3358,1,0,Uruguay,France,0,0,0.22426,0.11617,12,draw,draw
England,United States,1,1,FIFA World Cup,South Africa,12,6,2010,0,0,2,3359,1,0,England,United_States,0,0,0.69575,0.04495,12,draw,draw
Germany,Australia,4,0,FIFA World Cup,South Africa,13,6,2010,4,-4,4,3360,1,0,Germany,Australia,0,4,0.06444,0.75995,12,winner,loser
Serbia,Ghana,0,1,FIFA World Cup,South Africa,13,6,2010,-1,1,1,3361,1,0,Serbia,Ghana,0,1,0.82554,0.81816,12,loser,winner
Japan,Cameroon,1,0,FIFA World Cup,South Africa,14,6,2010,1,-1,1,3362,0,1,Japan,Cameroon,0,1,0.80814,0.86762,12,winner,loser
Netherlands,Denmark,2,0,FIFA World Cup,South Africa,14,6,2010,2,-2,2,3363,1,1,Netherlands,Denmark,0,2,0.83919,0.7921,12,winner,loser
Spain,Switzerland,0,1,FIFA World Cup,South Africa,16,6,2010,-1,1,1,3364,1,0,Spain,Switzerland,0,1,0.35529,0.99824,12,loser,winner
Argentina,South Korea,4,1,FIFA World Cup,South Africa,17,6,2010,3,-3,5,3365,1,0,Argentina,South_Korea,0,3,0.07683,0.31361,12,winner,loser
France,Mexico,0,2,FIFA World Cup,South Africa,17,6,2010,-2,2,2,3366,0,1,France,Mexico,0,2,0.10715,0.04483,12,loser,winner
Germany,Serbia,0,1,FIFA World Cup,South Africa,18,6,2010,-1,1,1,3367,1,1,Germany,Serbia,0,1,0.24104,0.62327,12,loser,winner
Cameroon,Denmark,1,2,FIFA World Cup,South Africa,19,6,2010,-1,1,3,3368,1,1,Cameroon,Denmark,0,1,0.77688,0.41931,12,loser,winner
Ghana,Australia,1,1,FIFA World Cup,South Africa,19,6,2010,0,0,2,3369,0,0,Ghana,Australia,0,0,0.54948,0.02343,12,draw,draw
Netherlands,Japan,1,0,FIFA World Cup,South Africa,19,6,2010,1,-1,1,3370,1,0,Netherlands,Japan,0,1,0.88577,0.81898,12,winner,loser
Mexico,Uruguay,0,1,FIFA World Cup,South Africa,22,6,2010,-1,1,1,3371,1,1,Mexico,Uruguay,0,1,0.94936,0.74944,12,loser,winner
Australia,Serbia,2,1,FIFA World Cup,South Africa,23,6,2010,1,-1,3,3372,0,1,Australia,Serbia,0,1,0.79225,0.83273,12,winner,loser
Ghana,Germany,0,1,FIFA World Cup,South Africa,23,6,2010,-1,1,1,3373,0,1,Ghana,Germany,0,1,0.09458,0.07696,12,loser,winner
Cameroon,Netherlands,1,2,FIFA World Cup,South Africa,24,6,2010,-1,1,3,3374,1,1,Cameroon,Netherlands,0,1,0.498,0.76081,12,loser,winner
Denmark,Japan,1,3,FIFA World Cup,South Africa,24,6,2010,-2,2,4,3375,1,0,Denmark,Japan,0,2,0.45454,0.80114,12,loser,winner
Portugal,Brazil,0,0,FIFA World Cup,South Africa,25,6,2010,0,0,0,3376,1,0,Portugal,Brazil,0,0,0.32133,0.62745,12,draw,draw
Uruguay,South Korea,2,1,FIFA World Cup,South Africa,26,6,2010,1,-1,3,3377,1,0,Uruguay,South_Korea,0,1,0.26865,0.54224,12,winner,loser
United States,Ghana,1,2,FIFA World Cup,South Africa,26,6,2010,-1,1,3,3378,0,0,United_States,Ghana,0,1,0.89619,0.97019,12,loser,winner
Argentina,Mexico,3,1,FIFA World Cup,South Africa,27,6,2010,2,-2,4,3379,1,1,Argentina,Mexico,0,2,0.7788,0.86461,12,winner,loser
Germany,England,4,1,FIFA World Cup,South Africa,27,6,2010,3,-3,5,3380,1,1,Germany,England,0,3,0.20147,0.01134,12,winner,loser
Spain,Portugal,1,0,FIFA World Cup,South Africa,29,6,2010,1,-1,1,3381,1,1,Spain,Portugal,0,1,0.5499,0.40658,12,winner,loser
Netherlands,Brazil,2,1,FIFA World Cup,South Africa,2,7,2010,1,-1,3,3382,1,0,Netherlands,Brazil,0,1,0.31405,0.65241,12,winner,loser
Uruguay,Ghana,1,1,FIFA World Cup,South Africa,2,7,2010,0,0,2,3383,1,0,Uruguay,Ghana,0,0,0.05973,0.58325,12,draw,draw
Argentina,Germany,0,4,FIFA World Cup,South Africa,3,7,2010,-4,4,4,3384,1,1,Argentina,Germany,0,4,0.79056,0.73739,12,loser,winner
Uruguay,Netherlands,2,3,FIFA World Cup,South Africa,6,7,2010,-1,1,5,3385,1,1,Uruguay,Netherlands,0,1,0.22767,0.22471,12,loser,winner
Germany,Spain,0,1,FIFA World Cup,South Africa,7,7,2010,-1,1,1,3386,1,1,Germany,Spain,0,1,0.81542,0.55983,12,loser,winner
Uruguay,Germany,2,3,FIFA World Cup,South Africa,10,7,2010,-1,1,5,3387,1,1,Uruguay,Germany,0,1,0.48674,0.29567,12,loser,winner
Netherlands,Spain,0,1,FIFA World Cup,South Africa,11,7,2010,-1,1,1,3388,1,1,Netherlands,Spain,0,1,0.47164,0.95524,12,loser,winner
United States,Brazil,0,2,Friendly,United States,10,8,2010,-2,2,2,3389,0,0,United_States,Brazil,0,2,0.54902,0.4586,12,loser,winner
Denmark,Germany,2,2,Friendly,Denmark,11,8,2010,0,0,4,3390,1,1,Denmark,Germany,0,0,0.93549,0.32042,12,draw,draw
Mexico,Spain,1,1,Friendly,Mexico,11,8,2010,0,0,2,3391,1,1,Mexico,Spain,0,0,0.08291,0.64403,12,draw,draw
Poland,Cameroon,0,3,Friendly,Poland,11,8,2010,-3,3,3,3392,0,1,Poland,Cameroon,0,3,0.97423,0.52537,12,loser,winner
Belgium,Germany,0,1,UEFA Euro qualification,Belgium,3,9,2010,-1,1,1,3393,1,1,Belgium,Germany,0,1,0.73551,0.14143,12,loser,winner
Switzerland,Australia,0,0,Friendly,Switzerland,3,9,2010,0,0,0,3394,0,0,Switzerland,Australia,0,0,0.52408,0.21139,12,draw,draw
Mexico,Ecuador,1,2,Friendly,Mexico,4,9,2010,-1,1,3,3395,1,0,Mexico,Ecuador,0,1,0.75195,0.72605,12,loser,winner
Argentina,Spain,4,1,Friendly,Argentina,7,9,2010,3,-3,5,3396,1,1,Argentina,Spain,0,3,0.63293,0.24296,12,winner,loser
South Korea,Iran,0,1,Friendly,South Korea,7,9,2010,-1,1,1,3397,0,1,South_Korea,Iran,0,1,0.2832,0.78602,12,loser,winner
Poland,Australia,1,2,Friendly,Poland,7,9,2010,-1,1,3,3398,0,0,Poland,Australia,0,1,0.10393,0.56917,12,loser,winner
Switzerland,England,1,3,UEFA Euro qualification,Switzerland,7,9,2010,-2,2,4,3399,0,1,Switzerland,England,0,2,0.95133,0.86019,12,loser,winner
Iran,Brazil,0,3,Friendly,United Arab Emirates,7,10,2010,-3,3,3,3400,1,0,Iran,Brazil,0,3,0.28044,0.55521,12,loser,winner
Japan,Argentina,1,0,Friendly,Japan,8,10,2010,1,-1,1,3401,0,1,Japan,Argentina,0,1,0.43392,0.20241,12,winner,loser
Portugal,Denmark,3,1,UEFA Euro qualification,Portugal,8,10,2010,2,-2,4,3402,1,1,Portugal,Denmark,0,2,0.35532,0.00557,12,winner,loser
United States,Poland,2,2,Friendly,United States,9,10,2010,0,0,4,3403,0,0,United_States,Poland,0,0,0.46196,0.04556,12,draw,draw
Ecuador,Poland,2,2,Friendly,Canada,12,10,2010,0,0,4,3404,0,0,Ecuador,Poland,0,0,0.87337,0.89286,12,draw,draw
South Korea,Japan,0,0,Friendly,South Korea,12,10,2010,0,0,0,3405,0,0,South_Korea,Japan,0,0,0.73204,0.70039,12,draw,draw
Switzerland,Wales,4,1,UEFA Euro qualification,Switzerland,12,10,2010,3,-3,5,3406,0,0,Switzerland,Wales,0,3,0.65453,0.53643,12,winner,loser
Argentina,Brazil,1,0,Friendly,Qatar,17,11,2010,1,-1,1,3407,1,0,Argentina,Brazil,0,1,0.38162,0.6201,12,winner,loser
England,France,1,2,Friendly,England,17,11,2010,-1,1,3,3408,1,0,England,France,0,1,0.96337,0.78719,12,loser,winner
Portugal,Spain,4,0,Friendly,Portugal,17,11,2010,4,-4,4,3409,1,1,Portugal,Spain,0,4,0.05103,0.45649,12,winner,loser
Saudi Arabia,Ghana,0,0,Friendly,United Arab Emirates,17,11,2010,0,0,0,3410,1,0,Saudi_Arabia,Ghana,0,0,0.3441,0.40593,12,draw,draw
Qatar,Saudi Arabia,1,1,Gulf Cup,Yemen,28,11,2010,0,0,2,3411,0,1,Qatar,Saudi_Arabia,0,0,0.10876,0.42533,12,draw,draw
Australia,South Korea,1,1,AFC Asian Cup,Qatar,14,1,2011,0,0,2,3412,0,0,Australia,South_Korea,1,0,0.12274,0.89927,12,draw,draw
Saudi Arabia,Japan,0,5,AFC Asian Cup,Qatar,17,1,2011,-5,5,5,3413,1,0,Saudi_Arabia,Japan,1,5,0.7259,0.20143,12,loser,winner
Qatar,Japan,2,3,AFC Asian Cup,Qatar,21,1,2011,-1,1,5,3414,0,0,Qatar,Japan,1,1,0.55683,0.12314,12,loser,winner
Iran,South Korea,0,1,AFC Asian Cup,Qatar,22,1,2011,-1,1,1,3415,1,0,Iran,South_Korea,1,1,0.78484,0.78745,12,loser,winner
Japan,South Korea,2,2,AFC Asian Cup,Qatar,25,1,2011,0,0,4,3416,0,0,Japan,South_Korea,1,0,0.19469,0.4176,12,draw,draw
Australia,Japan,0,1,AFC Asian Cup,Qatar,29,1,2011,-1,1,1,3417,0,0,Australia,Japan,1,1,0.70051,0.73558,12,loser,winner
Argentina,Portugal,2,1,Friendly,Switzerland,9,2,2011,1,-1,3,3418,1,1,Argentina,Portugal,1,1,0.3197,0.4982,12,winner,loser
Denmark,England,1,2,Friendly,Denmark,9,2,2011,-1,1,3,3419,1,1,Denmark,England,1,1,0.48267,0.24449,12,loser,winner
France,Brazil,1,0,Friendly,France,9,2,2011,1,-1,1,3420,0,0,France,Brazil,1,1,0.55013,0.53461,12,winner,loser
Senegal,Cameroon,1,0,African Cup of Nations qualification,Senegal,26,3,2011,1,-1,1,3421,0,1,Senegal,Cameroon,1,1,0.71827,0.96459,12,winner,loser
United States,Argentina,1,1,Friendly,United States,26,3,2011,0,0,2,3422,0,1,United_States,Argentina,1,0,0.67398,0.61301,12,draw,draw
Wales,England,0,2,UEFA Euro qualification,Wales,26,3,2011,-2,2,2,3423,0,1,Wales,England,1,2,0.67311,0.28835,12,loser,winner
Costa Rica,Argentina,0,0,Friendly,Costa Rica,29,3,2011,0,0,0,3424,1,1,Costa_Rica,Argentina,1,0,0.44927,0.25621,12,draw,draw
England,Ghana,1,1,Friendly,England,29,3,2011,0,0,2,3425,1,0,England,Ghana,1,0,0.07039,0.72576,12,draw,draw
France,Croatia,0,0,Friendly,France,29,3,2011,0,0,0,3426,0,0,France,Croatia,1,0,0.81365,0.20612,12,draw,draw
Germany,Australia,1,2,Friendly,Germany,29,3,2011,-1,1,3,3427,1,0,Germany,Australia,1,1,0.79898,0.56395,12,loser,winner
Argentina,Ecuador,2,2,Friendly,Argentina,20,4,2011,0,0,4,3428,1,0,Argentina,Ecuador,1,0,0.61599,0.53892,12,draw,draw
Mexico,Ecuador,1,1,Friendly,United States,28,5,2011,0,0,2,3429,1,0,Mexico,Ecuador,1,0,0.01197,0.54268,12,draw,draw
Germany,Uruguay,2,1,Friendly,Germany,29,5,2011,1,-1,3,3430,1,1,Germany,Uruguay,1,1,0.81435,0.72161,12,winner,loser
Canada,Ecuador,2,2,Friendly,Canada,1,6,2011,0,0,4,3431,0,0,Canada,Ecuador,1,0,0.32165,0.32781,12,draw,draw
South Korea,Serbia,2,1,Friendly,South Korea,3,6,2011,1,-1,3,3432,0,1,South_Korea,Serbia,1,1,0.33172,0.69408,12,winner,loser
Brazil,Netherlands,0,0,Friendly,Brazil,4,6,2011,0,0,0,3433,0,1,Brazil,Netherlands,1,0,0.2242,0.71277,12,draw,draw
Cameroon,Senegal,0,0,African Cup of Nations qualification,Cameroon,4,6,2011,0,0,0,3434,1,0,Cameroon,Senegal,1,0,0.29268,0.6286,12,draw,draw
England,Switzerland,2,2,UEFA Euro qualification,England,4,6,2011,0,0,4,3435,1,0,England,Switzerland,1,0,0.66598,0.97293,12,draw,draw
United States,Spain,0,4,Friendly,United States,4,6,2011,-4,4,4,3436,0,1,United_States,Spain,1,4,0.62231,0.57421,12,loser,winner
Poland,Argentina,2,1,Friendly,Poland,5,6,2011,1,-1,3,3437,0,1,Poland,Argentina,1,1,0.05335,0.29367,12,winner,loser
Australia,Serbia,0,0,Friendly,Australia,7,6,2011,0,0,0,3438,0,1,Australia,Serbia,1,0,0.53858,0.84022,12,draw,draw
South Korea,Ghana,2,1,Friendly,South Korea,7,6,2011,1,-1,3,3439,0,0,South_Korea,Ghana,1,1,0.75889,0.55537,12,winner,loser
United States,Canada,2,0,Gold Cup,United States,7,6,2011,2,-2,2,3440,0,0,United_States,Canada,1,2,0.90474,0.35838,12,winner,loser
Uruguay,Netherlands,1,1,Copa Confraternidad,Uruguay,8,6,2011,0,0,2,3441,1,1,Uruguay,Netherlands,1,0,0.48589,0.1633,12,draw,draw
Poland,France,0,1,Friendly,Poland,9,6,2011,-1,1,1,3442,0,0,Poland,France,1,1,0.01477,0.10194,12,loser,winner
Mexico,Costa Rica,4,1,Gold Cup,United States,12,6,2011,3,-3,5,3443,1,1,Mexico,Costa_Rica,1,3,0.14854,0.85519,12,winner,loser
United States,Mexico,2,4,Gold Cup,United States,25,6,2011,-2,2,6,3444,0,1,United_States,Mexico,1,2,0.90776,0.60109,12,loser,winner
Argentina,Costa Rica,3,0,Copa America,Argentina,11,7,2011,3,-3,3,3445,1,1,Argentina,Costa_Rica,1,3,0.168,0.67091,12,winner,loser
Uruguay,Mexico,1,0,Copa America,Argentina,12,7,2011,1,-1,1,3446,1,1,Uruguay,Mexico,1,1,0.30562,0.75405,12,winner,loser
Brazil,Ecuador,4,2,Copa America,Argentina,13,7,2011,2,-2,6,3447,0,0,Brazil,Ecuador,1,2,0.59776,0.047,12,winner,loser
Argentina,Uruguay,1,1,Copa America,Argentina,16,7,2011,0,0,2,3448,1,1,Argentina,Uruguay,1,0,0.26534,0.75047,12,draw,draw
Costa Rica,Ecuador,0,2,Friendly,Costa Rica,10,8,2011,-2,2,2,3449,1,0,Costa_Rica,Ecuador,1,2,0.57847,0.12947,12,loser,winner
Germany,Brazil,3,2,Friendly,Germany,10,8,2011,1,-1,5,3450,1,0,Germany,Brazil,1,1,0.46378,0.93139,12,winner,loser
Japan,South Korea,3,0,Friendly,Japan,10,8,2011,3,-3,3,3451,0,0,Japan,South_Korea,1,3,0.17778,0.7663,12,winner,loser
Senegal,Morocco,0,2,Friendly,Senegal,10,8,2011,-2,2,2,3452,0,0,Senegal,Morocco,1,2,0.17168,0.84594,12,loser,winner
United States,Mexico,1,1,Friendly,United States,10,8,2011,0,0,2,3453,0,1,United_States,Mexico,1,0,0.21712,0.34957,12,draw,draw
Wales,Australia,1,2,Friendly,Wales,10,8,2011,-1,1,3,3454,0,0,Wales,Australia,1,1,0.35504,0.5638,12,loser,winner
Poland,Mexico,1,1,Friendly,Poland,2,9,2011,0,0,2,3455,0,1,Poland,Mexico,1,0,0.66011,0.58241,12,draw,draw
United States,Costa Rica,0,1,Friendly,United States,2,9,2011,-1,1,1,3456,0,1,United_States,Costa_Rica,1,1,0.30127,0.94487,12,loser,winner
Brazil,Ghana,1,0,Friendly,England,5,9,2011,1,-1,1,3457,0,0,Brazil,Ghana,1,1,0.76134,0.84471,12,winner,loser
Belgium,United States,1,0,Friendly,Belgium,6,9,2011,1,-1,1,3458,1,0,Belgium,United_States,1,1,0.67099,0.2902,12,winner,loser
Ecuador,Costa Rica,4,0,Friendly,Ecuador,6,9,2011,4,-4,4,3459,0,1,Ecuador,Costa_Rica,1,4,0.99319,0.62975,12,winner,loser
England,Wales,1,0,UEFA Euro qualification,England,6,9,2011,1,-1,1,3460,1,0,England,Wales,1,1,0.62504,0.34474,12,winner,loser
Poland,Germany,2,2,Friendly,Poland,6,9,2011,0,0,4,3461,0,1,Poland,Germany,1,0,0.45293,0.05949,12,draw,draw
Qatar,Iran,1,1,FIFA World Cup qualification,Qatar,6,9,2011,0,0,2,3462,0,1,Qatar,Iran,1,0,0.20281,0.40799,12,draw,draw
Saudi Arabia,Australia,1,3,FIFA World Cup qualification,Saudi Arabia,6,9,2011,-2,2,4,3463,1,0,Saudi_Arabia,Australia,1,2,0.88573,0.80835,12,loser,winner
Argentina,Brazil,0,0,Supercl√°sico de las Am√©ricas,Argentina,14,9,2011,0,0,0,3464,1,0,Argentina,Brazil,1,0,0.98837,0.4644,12,draw,draw
Brazil,Argentina,2,0,Supercl√°sico de las Am√©ricas,Brazil,28,9,2011,2,-2,2,3465,0,1,Brazil,Argentina,1,2,0.4945,0.17409,12,winner,loser
Costa Rica,Brazil,0,1,Friendly,Costa Rica,7,10,2011,-1,1,1,3466,1,0,Costa_Rica,Brazil,1,1,0.93777,0.40887,12,loser,winner
South Korea,Poland,2,2,Friendly,South Korea,7,10,2011,0,0,4,3467,0,0,South_Korea,Poland,1,0,0.61915,0.19252,12,draw,draw
Wales,Switzerland,2,0,UEFA Euro qualification,Wales,7,10,2011,2,-2,2,3468,0,0,Wales,Switzerland,1,2,0.55427,6.10E-04,12,winner,loser
Denmark,Portugal,2,1,UEFA Euro qualification,Denmark,11,10,2011,1,-1,3,3469,1,1,Denmark,Portugal,1,1,0.97788,0.93862,12,winner,loser
Germany,Belgium,3,1,UEFA Euro qualification,Germany,11,10,2011,2,-2,4,3470,1,1,Germany,Belgium,1,2,0.48575,0.94251,12,winner,loser
Mexico,Brazil,1,2,Friendly,Mexico,11,10,2011,-1,1,3,3471,1,0,Mexico,Brazil,1,1,0.55806,0.24641,12,loser,winner
United States,Ecuador,0,1,Friendly,United States,11,10,2011,-1,1,1,3472,0,0,United_States,Ecuador,1,1,0.20944,0.42001,12,loser,winner
France,United States,1,0,Friendly,France,11,11,2011,1,-1,1,3473,0,0,France,United_States,1,1,0.84784,0.50174,12,winner,loser
Mexico,Serbia,2,0,Friendly,Mexico,11,11,2011,2,-2,2,3474,1,1,Mexico,Serbia,1,2,0.69901,0.97277,12,winner,loser
Netherlands,Switzerland,0,0,Friendly,Netherlands,11,11,2011,0,0,0,3475,1,0,Netherlands,Switzerland,1,0,0.45413,0.01404,12,draw,draw
England,Spain,1,0,Friendly,England,12,11,2011,1,-1,1,3476,1,1,England,Spain,1,1,0.26859,0.20792,12,winner,loser
Morocco,Cameroon,1,1,Friendly,Morocco,13,11,2011,0,0,2,3477,0,1,Morocco,Cameroon,1,0,0.18902,0.53696,12,draw,draw
Costa Rica,Spain,2,2,Friendly,Costa Rica,15,11,2011,0,0,4,3478,1,1,Costa_Rica,Spain,1,0,0.93231,0.92198,12,draw,draw
France,Belgium,0,0,Friendly,France,15,11,2011,0,0,0,3479,0,1,France,Belgium,1,0,0.19418,0.65366,12,draw,draw
Germany,Netherlands,3,0,Friendly,Germany,15,11,2011,3,-3,3,3480,1,1,Germany,Netherlands,1,3,0.17283,0.40139,12,winner,loser
Morocco,Tunisia,1,2,African Cup of Nations,Gabon,23,1,2012,-1,1,3,3481,0,1,Morocco,Tunisia,2,1,0.33404,0.84401,12,loser,winner
Ghana,Tunisia,2,1,African Cup of Nations,Gabon,5,2,2012,1,-1,3,3482,0,1,Ghana,Tunisia,2,1,0.61566,0.48,12,winner,loser
Australia,Saudi Arabia,4,2,FIFA World Cup qualification,Australia,29,2,2012,2,-2,6,3483,0,1,Australia,Saudi_Arabia,2,2,0.71497,0.58725,12,winner,loser
England,Netherlands,2,3,Friendly,England,29,2,2012,-1,1,5,3484,1,1,England,Netherlands,2,1,0.9011,0.90148,12,loser,winner
Germany,France,1,2,Friendly,Germany,29,2,2012,-1,1,3,3485,1,0,Germany,France,2,1,0.24207,0.64295,12,loser,winner
Iran,Qatar,2,2,FIFA World Cup qualification,Iran,29,2,2012,0,0,4,3486,1,0,Iran,Qatar,2,0,0.11216,0.81188,12,draw,draw
Poland,Portugal,0,0,Friendly,Poland,29,2,2012,0,0,0,3487,0,1,Poland,Portugal,2,0,0.45876,0.18418,12,draw,draw
Switzerland,Argentina,1,3,Friendly,Switzerland,29,2,2012,-2,2,4,3488,0,1,Switzerland,Argentina,2,2,0.67108,0.86922,12,loser,winner
Wales,Costa Rica,0,1,Friendly,Wales,29,2,2012,-1,1,1,3489,0,1,Wales,Costa_Rica,2,1,0.15603,0.70212,12,loser,winner
Morocco,Senegal,0,1,Friendly,Morocco,25,5,2012,-1,1,1,3490,0,0,Morocco,Senegal,2,1,0.52381,0.39447,12,loser,winner
Denmark,Brazil,1,3,Friendly,Germany,26,5,2012,-2,2,4,3491,1,0,Denmark,Brazil,2,2,0.90199,0.24713,12,loser,winner
Spain,Serbia,2,0,Friendly,Switzerland,26,5,2012,2,-2,2,3492,1,1,Spain,Serbia,2,2,0.79043,0.24282,12,winner,loser
Switzerland,Germany,5,3,Friendly,Switzerland,26,5,2012,2,-2,8,3493,0,1,Switzerland,Germany,2,2,0.06144,0.07279,12,winner,loser
Mexico,Wales,2,0,Friendly,United States,27,5,2012,2,-2,2,3494,1,0,Mexico,Wales,2,2,0.54409,0.44017,12,winner,loser
Spain,South Korea,4,1,Friendly,Switzerland,30,5,2012,3,-3,5,3495,1,0,Spain,South_Korea,2,3,0.65678,0.21584,12,winner,loser
United States,Brazil,1,4,Friendly,United States,30,5,2012,-3,3,5,3496,0,0,United_States,Brazil,2,3,0.353,0.25563,12,loser,winner
France,Serbia,2,0,Friendly,France,31,5,2012,2,-2,2,3497,0,1,France,Serbia,2,2,0.71393,0.48354,12,winner,loser
Argentina,Ecuador,4,0,FIFA World Cup qualification,Argentina,2,6,2012,4,-4,4,3498,1,0,Argentina,Ecuador,2,4,0.88982,0.0417,12,winner,loser
Denmark,Australia,2,0,Friendly,Denmark,2,6,2012,2,-2,2,3499,1,0,Denmark,Australia,2,2,0.03645,0.803,12,winner,loser
England,Belgium,1,0,Friendly,England,2,6,2012,1,-1,1,3500,1,1,England,Belgium,2,1,0.26857,0.12252,12,winner,loser
Canada,United States,0,0,Friendly,Canada,3,6,2012,0,0,0,3501,0,0,Canada,United_States,2,0,0.65716,0.31123,12,draw,draw
Mexico,Brazil,2,0,Friendly,United States,3,6,2012,2,-2,2,3502,1,0,Mexico,Brazil,2,2,0.90627,0.71454,12,winner,loser
Qatar,South Korea,1,4,FIFA World Cup qualification,Qatar,8,6,2012,-3,3,5,3503,0,0,Qatar,South_Korea,2,3,0.52873,0.39253,12,loser,winner
Brazil,Argentina,3,4,Friendly,United States,9,6,2012,-1,1,7,3504,0,1,Brazil,Argentina,2,1,0.31146,0.92692,12,loser,winner
Germany,Portugal,1,0,UEFA Euro,Ukraine,9,6,2012,1,-1,1,3505,1,1,Germany,Portugal,2,1,0.53642,0.55858,12,winner,loser
Netherlands,Denmark,0,1,UEFA Euro,Ukraine,9,6,2012,-1,1,1,3506,1,1,Netherlands,Denmark,2,1,0.37665,0.51982,12,loser,winner
France,England,1,1,UEFA Euro,Ukraine,11,6,2012,0,0,2,3507,0,1,France,England,2,0,0.104,0.93924,12,draw,draw
Australia,Japan,1,1,FIFA World Cup qualification,Australia,12,6,2012,0,0,2,3508,0,0,Australia,Japan,2,0,0.94977,0.29748,12,draw,draw
Iran,Qatar,0,0,FIFA World Cup qualification,Iran,12,6,2012,0,0,0,3509,1,0,Iran,Qatar,2,0,0.64785,0.46317,12,draw,draw
Denmark,Portugal,2,3,UEFA Euro,Ukraine,13,6,2012,-1,1,5,3510,1,1,Denmark,Portugal,2,1,0.18955,0.398,12,loser,winner
Netherlands,Germany,1,2,UEFA Euro,Ukraine,13,6,2012,-1,1,3,3511,1,1,Netherlands,Germany,2,1,0.25199,0.37021,12,loser,winner
Denmark,Germany,1,2,UEFA Euro,Ukraine,17,6,2012,-1,1,3,3512,1,1,Denmark,Germany,2,1,0.6549,0.78005,12,loser,winner
Portugal,Netherlands,2,1,UEFA Euro,Ukraine,17,6,2012,1,-1,3,3513,1,1,Portugal,Netherlands,2,1,0.40135,0.41561,12,winner,loser
Croatia,Spain,0,1,UEFA Euro,Poland,18,6,2012,-1,1,1,3514,0,1,Croatia,Spain,2,1,0.20718,0.12482,12,loser,winner
Saudi Arabia,Morocco,4,0,Friendly,Saudi Arabia,18,6,2012,4,-4,4,3515,1,0,Saudi_Arabia,Morocco,2,4,0.90843,0.03108,12,winner,loser
Spain,France,2,0,UEFA Euro,Ukraine,23,6,2012,2,-2,2,3516,1,0,Spain,France,2,2,0.19989,0.70183,12,winner,loser
Portugal,Spain,0,0,UEFA Euro,Ukraine,27,6,2012,0,0,0,3517,1,1,Portugal,Spain,2,0,0.56248,0.7753,12,draw,draw
Belgium,Netherlands,4,2,Friendly,Belgium,15,8,2012,2,-2,6,3518,1,1,Belgium,Netherlands,2,2,0.72308,0.5042,12,winner,loser
Croatia,Switzerland,2,4,Friendly,Croatia,15,8,2012,-2,2,6,3519,0,0,Croatia,Switzerland,2,2,0.99789,0.62488,12,loser,winner
France,Uruguay,0,0,Friendly,France,15,8,2012,0,0,0,3520,0,1,France,Uruguay,2,0,0.74725,0.20879,12,draw,draw
Germany,Argentina,1,3,Friendly,Germany,15,8,2012,-2,2,4,3521,1,1,Germany,Argentina,2,2,6.60E-04,0.11328,12,loser,winner
Iran,Tunisia,2,2,Friendly,Hungary,15,8,2012,0,0,4,3522,1,1,Iran,Tunisia,2,0,0.49242,0.44077,12,draw,draw
Mexico,United States,0,1,Friendly,Mexico,15,8,2012,-1,1,1,3523,1,0,Mexico,United_States,2,1,0.9761,0.83366,12,loser,winner
Costa Rica,Mexico,0,2,FIFA World Cup qualification,Costa Rica,7,9,2012,-2,2,2,3524,1,1,Costa_Rica,Mexico,2,2,0.82358,0.65747,12,loser,winner
Spain,Saudi Arabia,5,0,Friendly,Spain,7,9,2012,5,-5,5,3525,1,1,Spain,Saudi_Arabia,2,5,0.67049,0.46061,12,winner,loser
Wales,Belgium,0,2,FIFA World Cup qualification,Wales,7,9,2012,-2,2,2,3526,0,1,Wales,Belgium,2,2,0.97331,0.57949,12,loser,winner
Belgium,Croatia,1,1,FIFA World Cup qualification,Belgium,11,9,2012,0,0,2,3527,1,0,Belgium,Croatia,2,0,0.45568,0.48062,12,draw,draw
Mexico,Costa Rica,1,0,FIFA World Cup qualification,Mexico,11,9,2012,1,-1,1,3528,1,1,Mexico,Costa_Rica,2,1,0.16911,0.41404,12,winner,loser
Serbia,Wales,6,1,FIFA World Cup qualification,Serbia,11,9,2012,5,-5,7,3529,1,0,Serbia,Wales,2,5,0.22992,0.09703,12,winner,loser
Uruguay,Ecuador,1,1,FIFA World Cup qualification,Uruguay,11,9,2012,0,0,2,3530,1,0,Uruguay,Ecuador,2,0,0.92381,0.54636,12,draw,draw
Brazil,Argentina,2,1,Supercl√°sico de las Am√©ricas,Brazil,19,9,2012,1,-1,3,3531,0,1,Brazil,Argentina,2,1,0.13629,0.84193,12,winner,loser
Argentina,Uruguay,3,0,FIFA World Cup qualification,Argentina,12,10,2012,3,-3,3,3532,1,1,Argentina,Uruguay,2,3,0.27781,0.64245,12,winner,loser
France,Japan,0,1,Friendly,France,12,10,2012,-1,1,1,3533,0,0,France,Japan,2,1,0.78798,0.0453,12,loser,winner
Serbia,Belgium,0,3,FIFA World Cup qualification,Serbia,12,10,2012,-3,3,3,3534,1,1,Serbia,Belgium,2,3,0.7784,0.80276,12,loser,winner
Croatia,Wales,2,0,FIFA World Cup qualification,Croatia,16,10,2012,2,-2,2,3535,0,0,Croatia,Wales,2,2,0.39149,0.09045,12,winner,loser
Iran,South Korea,1,0,FIFA World Cup qualification,Iran,16,10,2012,1,-1,1,3536,1,0,Iran,South_Korea,2,1,0.95151,0.85516,12,winner,loser
Japan,Brazil,0,4,Friendly,Poland,16,10,2012,-4,4,4,3537,0,0,Japan,Brazil,2,4,0.82049,0.865,12,loser,winner
Spain,France,1,1,FIFA World Cup qualification,Spain,16,10,2012,0,0,2,3538,1,0,Spain,France,2,0,0.82937,0.24143,12,draw,draw
Poland,England,1,1,FIFA World Cup qualification,Poland,17,10,2012,0,0,2,3539,0,1,Poland,England,2,0,0.01395,0.35444,12,draw,draw
South Korea,Australia,1,2,Friendly,South Korea,14,11,2012,-1,1,3,3540,0,0,South_Korea,Australia,2,1,0.24092,0.43821,12,loser,winner
Netherlands,Germany,0,0,Friendly,Netherlands,14,11,2012,0,0,0,3541,1,1,Netherlands,Germany,2,0,0.27173,0.11812,12,draw,draw
Poland,Uruguay,1,3,Friendly,Poland,14,11,2012,-2,2,4,3542,0,1,Poland,Uruguay,2,2,0.22586,0.02963,12,loser,winner
Saudi Arabia,Argentina,0,0,Friendly,Saudi Arabia,14,11,2012,0,0,0,3543,1,1,Saudi_Arabia,Argentina,2,0,0.33776,0.28007,12,draw,draw
Tunisia,Switzerland,1,2,Friendly,Tunisia,14,11,2012,-1,1,3,3544,1,0,Tunisia,Switzerland,2,1,0.88749,0.9225,12,loser,winner
Argentina,Brazil,2,1,Supercl√°sico de las Am√©ricas,Argentina,21,11,2012,1,-1,3,3545,1,0,Argentina,Brazil,2,1,0.74029,0.4843,12,winner,loser
Iran,Saudi Arabia,0,0,WAFF Championship,Kuwait,9,12,2012,0,0,0,3546,1,1,Iran,Saudi_Arabia,2,0,0.7168,0.53755,12,draw,draw
Ghana,Tunisia,4,2,Friendly,United Arab Emirates,13,1,2013,2,-2,6,3547,0,1,Ghana,Tunisia,3,2,0.23932,0.4224,12,winner,loser
United States,Canada,0,0,Friendly,United States,29,1,2013,0,0,0,3548,0,0,United_States,Canada,3,0,0.87336,0.92162,12,draw,draw
Croatia,South Korea,4,0,Friendly,England,6,2,2013,4,-4,4,3549,0,0,Croatia,South_Korea,3,4,0.07697,0.85832,12,winner,loser
England,Brazil,2,1,Friendly,England,6,2,2013,1,-1,3,3550,1,0,England,Brazil,3,1,0.3343,0.16444,12,winner,loser
France,Germany,1,2,Friendly,France,6,2,2013,-1,1,3,3551,0,1,France,Germany,3,1,0.62024,0.61233,12,loser,winner
Portugal,Ecuador,2,3,Friendly,Portugal,6,2,2013,-1,1,5,3552,1,0,Portugal,Ecuador,3,1,0.25757,0.5012,12,loser,winner
Spain,Uruguay,3,1,Friendly,Qatar,6,2,2013,2,-2,4,3553,1,1,Spain,Uruguay,3,2,0.85893,0.64088,12,winner,loser
Croatia,Serbia,2,0,FIFA World Cup qualification,Croatia,22,3,2013,2,-2,2,3554,0,1,Croatia,Serbia,3,2,0.71545,0.31318,12,winner,loser
Japan,Canada,2,1,Friendly,Qatar,22,3,2013,1,-1,3,3555,0,0,Japan,Canada,3,1,0.49954,0.38977,12,winner,loser
United States,Costa Rica,1,0,FIFA World Cup qualification,United States,22,3,2013,1,-1,1,3556,0,1,United_States,Costa_Rica,3,1,0.47483,0.95106,12,winner,loser
France,Spain,0,1,FIFA World Cup qualification,France,26,3,2013,-1,1,1,3557,0,1,France,Spain,3,1,0.74745,0.0425,12,loser,winner
South Korea,Qatar,2,1,FIFA World Cup qualification,South Korea,26,3,2013,1,-1,3,3558,0,0,South_Korea,Qatar,3,1,0.71526,0.39626,12,winner,loser
Mexico,United States,0,0,FIFA World Cup qualification,Mexico,26,3,2013,0,0,0,3559,1,0,Mexico,United_States,3,0,0.98855,0.22424,12,draw,draw
Wales,Croatia,1,2,FIFA World Cup qualification,Wales,26,3,2013,-1,1,3,3560,0,0,Wales,Croatia,3,1,0.37484,0.66241,12,loser,winner
Canada,Costa Rica,0,1,Friendly,Canada,28,5,2013,-1,1,1,3561,0,1,Canada,Costa_Rica,3,1,0.24244,0.06136,12,loser,winner
Ecuador,Germany,2,4,Friendly,United States,29,5,2013,-2,2,6,3562,0,1,Ecuador,Germany,3,2,0.98999,0.57723,12,loser,winner
United States,Belgium,2,4,Friendly,United States,29,5,2013,-2,2,6,3563,0,1,United_States,Belgium,3,2,0.18518,0.89271,12,loser,winner
Brazil,England,2,2,Friendly,Brazil,2,6,2013,0,0,4,3564,0,1,Brazil,England,3,0,0.71713,0.71846,12,draw,draw
United States,Germany,4,3,Friendly,United States,2,6,2013,1,-1,7,3565,0,1,United_States,Germany,3,1,0.40698,0.98659,12,winner,loser
Japan,Australia,1,1,FIFA World Cup qualification,Japan,4,6,2013,0,0,2,3566,0,0,Japan,Australia,3,0,0.29492,0.8756,12,draw,draw
Qatar,Iran,0,1,FIFA World Cup qualification,Qatar,4,6,2013,-1,1,1,3567,0,1,Qatar,Iran,3,1,0.52398,0.84639,12,loser,winner
Uruguay,France,1,0,Friendly,Uruguay,5,6,2013,1,-1,1,3568,1,0,Uruguay,France,3,1,0.30856,0.5134,12,winner,loser
Belgium,Serbia,2,1,FIFA World Cup qualification,Belgium,7,6,2013,1,-1,3,3569,1,1,Belgium,Serbia,3,1,0.37553,0.06688,12,winner,loser
Brazil,France,3,0,Friendly,Brazil,9,6,2013,3,-3,3,3570,0,0,Brazil,France,3,3,0.78443,0.92454,12,winner,loser
Croatia,Portugal,0,1,Friendly,Switzerland,10,6,2013,-1,1,1,3571,0,1,Croatia,Portugal,3,1,0.46229,0.45471,12,loser,winner
Ecuador,Argentina,1,1,FIFA World Cup qualification,Ecuador,11,6,2013,0,0,2,3572,0,1,Ecuador,Argentina,3,0,0.81091,0.77752,12,draw,draw
Mexico,Costa Rica,0,0,FIFA World Cup qualification,Mexico,11,6,2013,0,0,0,3573,1,1,Mexico,Costa_Rica,3,0,0.36364,0.87906,12,draw,draw
Brazil,Japan,3,0,Confederations Cup,Brazil,15,6,2013,3,-3,3,3574,0,0,Brazil,Japan,3,3,0.64621,0.94209,12,winner,loser
Spain,Uruguay,2,1,Confederations Cup,Brazil,16,6,2013,1,-1,3,3575,1,1,Spain,Uruguay,3,1,0.24838,0.28367,12,winner,loser
South Korea,Iran,0,1,FIFA World Cup qualification,South Korea,18,6,2013,-1,1,1,3576,0,1,South_Korea,Iran,3,1,0.08889,0.75699,12,loser,winner
Brazil,Mexico,2,0,Confederations Cup,Brazil,19,6,2013,2,-2,2,3577,0,1,Brazil,Mexico,3,2,0.22232,0.82556,12,winner,loser
Japan,Mexico,1,2,Confederations Cup,Brazil,22,6,2013,-1,1,3,3578,0,1,Japan,Mexico,3,1,0.97302,0.04495,12,loser,winner
Brazil,Uruguay,2,1,Confederations Cup,Brazil,26,6,2013,1,-1,3,3579,0,1,Brazil,Uruguay,3,1,0.72287,0.13659,12,winner,loser
Brazil,Spain,3,0,Confederations Cup,Brazil,30,6,2013,3,-3,3,3580,0,1,Brazil,Spain,3,3,0.21277,0.56259,12,winner,loser
Mexico,Canada,2,0,Gold Cup,United States,11,7,2013,2,-2,2,3581,1,0,Mexico,Canada,3,2,0.28251,0.03794,12,winner,loser
Morocco,Tunisia,0,0,African Nations Championship,Morocco,13,7,2013,0,0,0,3582,0,1,Morocco,Tunisia,3,0,0.08703,0.42505,12,draw,draw
United States,Costa Rica,1,0,Gold Cup,United States,16,7,2013,1,-1,1,3583,0,1,United_States,Costa_Rica,3,1,0.88012,0.6279,12,winner,loser
South Korea,Australia,0,0,EAFF Championship,South Korea,20,7,2013,0,0,0,3584,0,0,South_Korea,Australia,3,0,0.48483,0.91725,12,draw,draw
Japan,Australia,3,2,EAFF Championship,South Korea,25,7,2013,1,-1,5,3585,0,0,Japan,Australia,3,1,0.78868,0.64497,12,winner,loser
South Korea,Japan,1,2,EAFF Championship,South Korea,28,7,2013,-1,1,3,3586,0,0,South_Korea,Japan,3,1,0.07198,0.78742,12,loser,winner
Belgium,France,0,0,Friendly,Belgium,14,8,2013,0,0,0,3587,1,0,Belgium,France,3,0,0.18264,0.39925,12,draw,draw
Ecuador,Spain,0,2,Friendly,Ecuador,14,8,2013,-2,2,2,3588,0,1,Ecuador,Spain,3,2,0.88845,0.93516,12,loser,winner
Japan,Uruguay,2,4,Friendly,Japan,14,8,2013,-2,2,6,3589,0,1,Japan,Uruguay,3,2,0.77822,0.14343,12,loser,winner
Poland,Denmark,3,2,Friendly,Poland,14,8,2013,1,-1,5,3590,0,1,Poland,Denmark,3,1,0.96776,0.9947,12,winner,loser
Portugal,Netherlands,1,1,Friendly,Portugal,14,8,2013,0,0,2,3591,1,1,Portugal,Netherlands,3,0,0.37347,0.22482,12,draw,draw
Switzerland,Brazil,1,0,Friendly,Switzerland,14,8,2013,1,-1,1,3592,0,0,Switzerland,Brazil,3,1,0.08331,0.98207,12,winner,loser
Costa Rica,United States,3,1,FIFA World Cup qualification,Costa Rica,6,9,2013,2,-2,4,3593,1,0,Costa_Rica,United_States,3,2,0.4871,0.16076,12,winner,loser
Serbia,Croatia,1,1,FIFA World Cup qualification,Serbia,6,9,2013,0,0,2,3594,1,0,Serbia,Croatia,3,0,0.81268,0.09906,12,draw,draw
Brazil,Australia,6,0,Friendly,Brazil,7,9,2013,6,-6,6,3595,0,0,Brazil,Australia,3,6,0.83366,0.25723,12,winner,loser
Brazil,Portugal,3,1,Friendly,United States,10,9,2013,2,-2,4,3596,0,1,Brazil,Portugal,3,2,0.16067,0.84691,12,winner,loser
Japan,Ghana,3,1,Friendly,Japan,10,9,2013,2,-2,4,3597,0,0,Japan,Ghana,3,2,0.3219,0.28644,12,winner,loser
South Korea,Croatia,1,2,Friendly,South Korea,10,9,2013,-1,1,3,3598,0,0,South_Korea,Croatia,3,1,0.03709,0.14957,12,loser,winner
United States,Mexico,2,0,FIFA World Cup qualification,United States,10,9,2013,2,-2,2,3599,0,1,United_States,Mexico,3,2,0.46141,0.36892,12,winner,loser
Wales,Serbia,0,3,FIFA World Cup qualification,Wales,10,9,2013,-3,3,3,3600,0,1,Wales,Serbia,3,3,0.38412,0.4196,12,loser,winner
Croatia,Belgium,1,2,FIFA World Cup qualification,Croatia,11,10,2013,-1,1,3,3601,0,1,Croatia,Belgium,3,1,0.73138,0.22165,12,loser,winner
Ecuador,Uruguay,1,0,FIFA World Cup qualification,Ecuador,11,10,2013,1,-1,1,3602,0,1,Ecuador,Uruguay,3,1,0.25234,0.86397,12,winner,loser
France,Australia,6,0,Friendly,France,11,10,2013,6,-6,6,3603,0,0,France,Australia,3,6,0.08665,0.5826,12,winner,loser
Serbia,Japan,2,0,Friendly,Serbia,11,10,2013,2,-2,2,3604,1,0,Serbia,Japan,3,2,0.63574,0.19237,12,winner,loser
South Korea,Brazil,0,2,Friendly,South Korea,12,10,2013,-2,2,2,3605,0,0,South_Korea,Brazil,3,2,0.46865,0.81203,12,loser,winner
Tunisia,Cameroon,0,0,FIFA World Cup qualification,Tunisia,13,10,2013,0,0,0,3606,1,1,Tunisia,Cameroon,3,0,0.09545,0.19248,12,draw,draw
Australia,Canada,3,0,Friendly,England,15,10,2013,3,-3,3,3607,0,0,Australia,Canada,3,3,0.32379,0.98588,12,winner,loser
Belgium,Wales,1,1,FIFA World Cup qualification,Belgium,15,10,2013,0,0,2,3608,1,0,Belgium,Wales,3,0,0.33316,0.60803,12,draw,draw
Costa Rica,Mexico,2,1,FIFA World Cup qualification,Costa Rica,15,10,2013,1,-1,3,3609,1,1,Costa_Rica,Mexico,3,1,0.84711,0.65755,12,winner,loser
England,Poland,2,0,FIFA World Cup qualification,England,15,10,2013,2,-2,2,3610,1,0,England,Poland,3,2,0.72191,0.52833,12,winner,loser
Uruguay,Argentina,3,2,FIFA World Cup qualification,Uruguay,15,10,2013,1,-1,5,3611,1,1,Uruguay,Argentina,3,1,0.55296,0.12553,12,winner,loser
Argentina,Ecuador,0,0,Friendly,United States,15,11,2013,0,0,0,3612,1,0,Argentina,Ecuador,3,0,0.02703,0.32247,12,draw,draw
South Korea,Switzerland,2,1,Friendly,South Korea,15,11,2013,1,-1,3,3613,0,0,South_Korea,Switzerland,3,1,0.12975,0.21858,12,winner,loser
Netherlands,Japan,2,2,Friendly,Belgium,16,11,2013,0,0,4,3614,1,0,Netherlands,Japan,3,0,0.4169,0.97852,12,draw,draw
Cameroon,Tunisia,4,1,FIFA World Cup qualification,Cameroon,17,11,2013,3,-3,5,3615,1,1,Cameroon,Tunisia,3,3,0.15578,0.4274,12,winner,loser
Australia,Costa Rica,1,0,Friendly,Australia,19,11,2013,1,-1,1,3616,0,1,Australia,Costa_Rica,3,1,0.84568,0.37449,12,winner,loser
Belgium,Japan,2,3,Friendly,Belgium,19,11,2013,-1,1,5,3617,1,0,Belgium,Japan,3,1,0.00682,0.83791,12,loser,winner
England,Germany,0,1,Friendly,England,19,11,2013,-1,1,1,3618,1,1,England,Germany,3,1,0.1245,0.14325,12,loser,winner
Qatar,Saudi Arabia,4,1,WAFF Championship,Qatar,31,12,2013,3,-3,5,3619,0,1,Qatar,Saudi_Arabia,3,3,0.57862,0.18258,12,winner,loser
Costa Rica,South Korea,0,1,Friendly,United States,25,1,2014,-1,1,1,3620,1,0,Costa_Rica,South_Korea,4,1,0.27119,0.81442,12,loser,winner
Mexico,South Korea,4,0,Friendly,United States,29,1,2014,4,-4,4,3621,1,0,Mexico,South_Korea,4,4,0.57438,0.31935,12,winner,loser
United States,South Korea,2,0,Friendly,United States,1,2,2014,2,-2,2,3622,0,0,United_States,South_Korea,4,2,0.3004,0.64029,12,winner,loser
Australia,Ecuador,3,4,Friendly,England,5,3,2014,-1,1,7,3623,0,0,Australia,Ecuador,4,1,0.38415,0.02716,12,loser,winner
England,Denmark,1,0,Friendly,England,5,3,2014,1,-1,1,3624,1,1,England,Denmark,4,1,0.39828,0.84078,12,winner,loser
France,Netherlands,2,0,Friendly,France,5,3,2014,2,-2,2,3625,0,1,France,Netherlands,4,2,0.44443,0.78601,12,winner,loser
Portugal,Cameroon,5,1,Friendly,Portugal,5,3,2014,4,-4,6,3626,1,1,Portugal,Cameroon,4,4,0.91404,0.25693,12,winner,loser
Switzerland,Croatia,2,2,Friendly,Switzerland,5,3,2014,0,0,4,3627,0,0,Switzerland,Croatia,4,0,0.5939,0.89401,12,draw,draw
Germany,Poland,0,0,Friendly,Germany,13,5,2014,0,0,0,3628,1,0,Germany,Poland,4,0,0.7096,0.2125,12,draw,draw
Netherlands,Ecuador,1,1,Friendly,Netherlands,17,5,2014,0,0,2,3629,1,0,Netherlands,Ecuador,4,0,0.84989,0.75083,12,draw,draw
South Korea,Tunisia,0,1,Friendly,South Korea,28,5,2014,-1,1,1,3630,0,1,South_Korea,Tunisia,4,1,0.12065,0.1208,12,loser,winner
Mexico,Ecuador,3,1,Friendly,United States,31,5,2014,2,-2,4,3631,1,0,Mexico,Ecuador,4,2,0.61575,0.59614,12,winner,loser
Netherlands,Ghana,1,0,Friendly,Netherlands,31,5,2014,1,-1,1,3632,1,0,Netherlands,Ghana,4,1,0.17383,0.88413,12,winner,loser
Germany,Cameroon,2,2,Friendly,Germany,1,6,2014,0,0,4,3633,1,1,Germany,Cameroon,4,0,0.86414,0.58092,12,draw,draw
Costa Rica,Japan,1,3,Friendly,United States,2,6,2014,-2,2,4,3634,1,0,Costa_Rica,Japan,4,2,0.86109,0.28084,12,loser,winner
Ecuador,England,2,2,Friendly,United States,4,6,2014,0,0,4,3635,0,1,Ecuador,England,4,0,0.17389,0.6431,12,draw,draw
Netherlands,Wales,2,0,Friendly,Netherlands,4,6,2014,2,-2,2,3636,1,0,Netherlands,Wales,4,2,0.27897,0.27856,12,winner,loser
Brazil,Serbia,1,0,Friendly,Brazil,6,6,2014,1,-1,1,3637,0,1,Brazil,Serbia,4,1,0.79357,0.25684,12,winner,loser
Croatia,Australia,1,0,Friendly,Brazil,6,6,2014,1,-1,1,3638,0,0,Croatia,Australia,4,1,0.77883,0.06113,12,winner,loser
Mexico,Portugal,0,1,Friendly,United States,6,6,2014,-1,1,1,3639,1,1,Mexico,Portugal,4,1,0.66731,0.2388,12,loser,winner
Belgium,Tunisia,1,0,Friendly,Belgium,7,6,2014,1,-1,1,3640,1,1,Belgium,Tunisia,4,1,0.34745,0.10322,12,winner,loser
Ghana,South Korea,4,0,Friendly,United States,9,6,2014,4,-4,4,3641,0,0,Ghana,South_Korea,4,4,0.83816,0.79662,12,winner,loser
Brazil,Croatia,3,1,FIFA World Cup,Brazil,12,6,2014,2,-2,4,3642,0,0,Brazil,Croatia,4,2,0.45596,0.35923,12,winner,loser
Mexico,Cameroon,1,0,FIFA World Cup,Brazil,13,6,2014,1,-1,1,3643,1,1,Mexico,Cameroon,4,1,0.38934,0.89751,12,winner,loser
Spain,Netherlands,1,5,FIFA World Cup,Brazil,13,6,2014,-4,4,6,3644,1,1,Spain,Netherlands,4,4,0.75438,0.56789,12,loser,winner
Uruguay,Costa Rica,1,3,FIFA World Cup,Brazil,14,6,2014,-2,2,4,3645,1,1,Uruguay,Costa_Rica,4,2,0.24053,0.35674,12,loser,winner
Switzerland,Ecuador,2,1,FIFA World Cup,Brazil,15,6,2014,1,-1,3,3646,0,0,Switzerland,Ecuador,4,1,0.37553,0.6586,12,winner,loser
Germany,Portugal,4,0,FIFA World Cup,Brazil,16,6,2014,4,-4,4,3647,1,1,Germany,Portugal,4,4,0.52919,0.87255,12,winner,loser
Ghana,United States,1,2,FIFA World Cup,Brazil,16,6,2014,-1,1,3,3648,0,0,Ghana,United_States,4,1,0.39433,0.21672,12,loser,winner
Brazil,Mexico,0,0,FIFA World Cup,Brazil,17,6,2014,0,0,0,3649,0,1,Brazil,Mexico,4,0,0.10201,0.08207,12,draw,draw
Australia,Netherlands,2,3,FIFA World Cup,Brazil,18,6,2014,-1,1,5,3650,0,1,Australia,Netherlands,4,1,0.80958,0.768,12,loser,winner
Cameroon,Croatia,0,4,FIFA World Cup,Brazil,18,6,2014,-4,4,4,3651,1,0,Cameroon,Croatia,4,4,0.97576,0.77744,12,loser,winner
Uruguay,England,2,1,FIFA World Cup,Brazil,19,6,2014,1,-1,3,3652,1,1,Uruguay,England,4,1,0.36386,0.97106,12,winner,loser
Switzerland,France,2,5,FIFA World Cup,Brazil,20,6,2014,-3,3,7,3653,0,0,Switzerland,France,4,3,0.74553,0.09552,12,loser,winner
Argentina,Iran,1,0,FIFA World Cup,Brazil,21,6,2014,1,-1,1,3654,1,1,Argentina,Iran,4,1,0.61077,0.35362,12,winner,loser
Germany,Ghana,2,2,FIFA World Cup,Brazil,21,6,2014,0,0,4,3655,1,0,Germany,Ghana,4,0,0.93961,0.40175,12,draw,draw
United States,Portugal,2,2,FIFA World Cup,Brazil,22,6,2014,0,0,4,3656,0,1,United_States,Portugal,4,0,0.42993,0.83034,12,draw,draw
Australia,Spain,0,3,FIFA World Cup,Brazil,23,6,2014,-3,3,3,3657,0,1,Australia,Spain,4,3,0.60695,0.33488,12,loser,winner
Brazil,Cameroon,4,1,FIFA World Cup,Brazil,23,6,2014,3,-3,5,3658,0,1,Brazil,Cameroon,4,3,0.1888,0.21755,12,winner,loser
Croatia,Mexico,1,3,FIFA World Cup,Brazil,23,6,2014,-2,2,4,3659,0,1,Croatia,Mexico,4,2,0.69892,0.82512,12,loser,winner
Costa Rica,England,0,0,FIFA World Cup,Brazil,24,6,2014,0,0,0,3660,1,1,Costa_Rica,England,4,0,0.43101,0.92666,12,draw,draw
Ecuador,France,0,0,FIFA World Cup,Brazil,25,6,2014,0,0,0,3661,0,0,Ecuador,France,4,0,0.08677,0.71704,12,draw,draw
South Korea,Belgium,0,1,FIFA World Cup,Brazil,26,6,2014,-1,1,1,3662,0,1,South_Korea,Belgium,4,1,0.15725,0.53487,12,loser,winner
Portugal,Ghana,2,1,FIFA World Cup,Brazil,26,6,2014,1,-1,3,3663,1,0,Portugal,Ghana,4,1,0.96695,0.7788,12,winner,loser
United States,Germany,0,1,FIFA World Cup,Brazil,26,6,2014,-1,1,1,3664,0,1,United_States,Germany,4,1,0.93504,0.86025,12,loser,winner
Netherlands,Mexico,2,1,FIFA World Cup,Brazil,29,6,2014,1,-1,3,3665,1,1,Netherlands,Mexico,4,1,9.00E-04,0.67731,12,winner,loser
Argentina,Switzerland,1,0,FIFA World Cup,Brazil,1,7,2014,1,-1,1,3666,1,0,Argentina,Switzerland,4,1,0.03498,0.67955,12,winner,loser
Belgium,United States,2,1,FIFA World Cup,Brazil,1,7,2014,1,-1,3,3667,1,0,Belgium,United_States,4,1,0.72521,0.07647,12,winner,loser
France,Germany,0,1,FIFA World Cup,Brazil,4,7,2014,-1,1,1,3668,0,1,France,Germany,4,1,0.99043,0.90305,12,loser,winner
Argentina,Belgium,1,0,FIFA World Cup,Brazil,5,7,2014,1,-1,1,3669,1,1,Argentina,Belgium,4,1,0.50334,0.06534,12,winner,loser
Netherlands,Costa Rica,0,0,FIFA World Cup,Brazil,5,7,2014,0,0,0,3670,1,1,Netherlands,Costa_Rica,4,0,0.49738,0.00151,12,draw,draw
Brazil,Germany,1,7,FIFA World Cup,Brazil,8,7,2014,-6,6,8,3671,0,1,Brazil,Germany,4,6,0.61507,0.70198,12,loser,winner
Netherlands,Argentina,0,0,FIFA World Cup,Brazil,9,7,2014,0,0,0,3672,1,1,Netherlands,Argentina,4,0,0.17642,0.80577,12,draw,draw
Brazil,Netherlands,0,3,FIFA World Cup,Brazil,12,7,2014,-3,3,3,3673,0,1,Brazil,Netherlands,4,3,0.42708,0.32368,12,loser,winner
Germany,Argentina,1,0,FIFA World Cup,Brazil,13,7,2014,1,-1,1,3674,1,1,Germany,Argentina,4,1,0.70367,0.92084,12,winner,loser
Germany,Argentina,2,4,Friendly,Germany,3,9,2014,-2,2,6,3675,1,1,Germany,Argentina,4,2,0.56279,0.72898,12,loser,winner
Morocco,Qatar,0,0,Friendly,Morocco,3,9,2014,0,0,0,3676,0,0,Morocco,Qatar,4,0,0.12709,0.68767,12,draw,draw
Belgium,Australia,2,0,Friendly,Belgium,4,9,2014,2,-2,2,3677,1,0,Belgium,Australia,4,2,0.21802,0.63414,12,winner,loser
France,Spain,1,0,Friendly,France,4,9,2014,1,-1,1,3678,0,1,France,Spain,4,1,0.36961,0.67878,12,winner,loser
Japan,Uruguay,0,2,Kirin Challenge Cup,Japan,5,9,2014,-2,2,2,3679,0,1,Japan,Uruguay,4,2,0.96283,0.83648,12,loser,winner
Serbia,France,1,1,Friendly,Serbia,7,9,2014,0,0,2,3680,1,0,Serbia,France,4,0,0.0811,0.3479,12,draw,draw
Australia,Saudi Arabia,3,2,Friendly,England,8,9,2014,1,-1,5,3681,0,1,Australia,Saudi_Arabia,4,1,0.2286,0.84932,12,winner,loser
South Korea,Uruguay,0,1,Friendly,South Korea,8,9,2014,-1,1,1,3682,0,1,South_Korea,Uruguay,4,1,0.71204,0.27934,12,loser,winner
Switzerland,England,0,2,UEFA Euro qualification,Switzerland,8,9,2014,-2,2,2,3683,0,1,Switzerland,England,4,2,0.6913,0.09646,12,loser,winner
Saudi Arabia,Uruguay,1,1,Friendly,Saudi Arabia,10,10,2014,0,0,2,3684,1,1,Saudi_Arabia,Uruguay,4,0,0.87784,0.68896,12,draw,draw
Senegal,Tunisia,0,0,African Cup of Nations qualification,Senegal,10,10,2014,0,0,0,3685,0,1,Senegal,Tunisia,4,0,0.6874,0.96654,12,draw,draw
Argentina,Brazil,0,2,Supercl√°sico de las Am√©ricas,China PR,11,10,2014,-2,2,2,3686,1,0,Argentina,Brazil,4,2,0.85917,0.20205,12,loser,winner
France,Portugal,2,1,Friendly,France,11,10,2014,1,-1,3,3687,0,1,France,Portugal,4,1,0.01543,0.71385,12,winner,loser
Poland,Germany,2,0,UEFA Euro qualification,Poland,11,10,2014,2,-2,2,3688,0,1,Poland,Germany,4,2,0.80997,0.81748,12,winner,loser
Denmark,Portugal,0,1,UEFA Euro qualification,Denmark,14,10,2014,-1,1,1,3689,1,1,Denmark,Portugal,4,1,0.60219,0.96351,12,loser,winner
Japan,Brazil,0,4,Friendly,Singapore,14,10,2014,-4,4,4,3690,0,0,Japan,Brazil,4,4,0.18225,0.86848,12,loser,winner
South Korea,Costa Rica,1,3,Friendly,South Korea,14,10,2014,-2,2,4,3691,0,1,South_Korea,Costa_Rica,4,2,0.63659,0.30006,12,loser,winner
Qatar,Australia,1,0,Friendly,Qatar,14,10,2014,1,-1,1,3692,0,0,Qatar,Australia,4,1,0.75546,0.37979,12,winner,loser
Tunisia,Senegal,1,0,African Cup of Nations qualification,Tunisia,15,10,2014,1,-1,1,3693,1,0,Tunisia,Senegal,4,1,0.8943,0.3171,12,winner,loser
Argentina,Croatia,2,1,Friendly,England,12,11,2014,1,-1,3,3694,1,0,Argentina,Croatia,4,1,0.67328,0.97235,12,winner,loser
Netherlands,Mexico,2,3,Friendly,Netherlands,12,11,2014,-1,1,5,3695,1,1,Netherlands,Mexico,4,1,0.48198,0.60564,12,loser,winner
Saudi Arabia,Qatar,1,1,Gulf Cup,Saudi Arabia,13,11,2014,0,0,2,3696,1,0,Saudi_Arabia,Qatar,4,0,0.29477,0.73713,12,draw,draw
Uruguay,Costa Rica,3,3,Friendly,Uruguay,13,11,2014,0,0,6,3697,1,1,Uruguay,Costa_Rica,4,0,0.03219,0.19009,12,draw,draw
Serbia,Denmark,1,3,UEFA Euro qualification,Serbia,14,11,2014,-2,2,4,3698,1,1,Serbia,Denmark,4,2,0.67093,0.89581,12,loser,winner
Belgium,Wales,0,0,UEFA Euro qualification,Belgium,16,11,2014,0,0,0,3699,1,0,Belgium,Wales,4,0,0.06761,0.27732,12,draw,draw
Iran,South Korea,1,0,Friendly,Iran,18,11,2014,1,-1,1,3700,1,0,Iran,South_Korea,4,1,0.4452,0.94333,12,winner,loser
Japan,Australia,2,1,Friendly,Japan,18,11,2014,1,-1,3,3701,0,0,Japan,Australia,4,1,0.11362,0.63267,12,winner,loser
Portugal,Argentina,1,0,Friendly,England,18,11,2014,1,-1,1,3702,1,1,Portugal,Argentina,4,1,0.37222,0.48733,12,winner,loser
Spain,Germany,0,1,Friendly,Spain,18,11,2014,-1,1,1,3703,1,1,Spain,Germany,4,1,0.71893,0.00205,12,loser,winner
Saudi Arabia,Qatar,1,2,Gulf Cup,Saudi Arabia,26,11,2014,-1,1,3,3704,1,0,Saudi_Arabia,Qatar,4,1,0.30284,0.60529,12,loser,winner
South Korea,Saudi Arabia,2,0,Friendly,Australia,4,1,2015,2,-2,2,3705,0,1,South_Korea,Saudi_Arabia,5,2,0.4197,0.53455,12,winner,loser
Qatar,Iran,0,1,AFC Asian Cup,Australia,15,1,2015,-1,1,1,3706,0,1,Qatar,Iran,5,1,0.75873,0.26276,12,loser,winner
Australia,South Korea,0,1,AFC Asian Cup,Australia,17,1,2015,-1,1,1,3707,0,0,Australia,South_Korea,5,1,0.51463,0.69972,12,loser,winner
Ghana,Senegal,1,2,African Cup of Nations,Equatorial Guinea,19,1,2015,-1,1,3,3708,0,0,Ghana,Senegal,5,1,0.04238,0.65333,12,loser,winner
Australia,South Korea,2,1,AFC Asian Cup,Australia,31,1,2015,1,-1,3,3709,0,0,Australia,South_Korea,5,1,0.05384,0.13448,12,winner,loser
Denmark,United States,3,2,Friendly,Denmark,25,3,2015,1,-1,5,3710,1,0,Denmark,United_States,5,1,0.95633,0.80866,12,winner,loser
Germany,Australia,2,2,Friendly,Germany,25,3,2015,0,0,4,3711,1,0,Germany,Australia,5,0,0.18715,0.44962,12,draw,draw
France,Brazil,1,3,Friendly,France,26,3,2015,-2,2,4,3712,0,0,France,Brazil,5,2,0.37537,0.19102,12,loser,winner
Japan,Tunisia,2,0,Kirin Challenge Cup,Japan,27,3,2015,2,-2,2,3713,0,1,Japan,Tunisia,5,2,0.70256,0.5832,12,winner,loser
Ghana,Senegal,1,2,Friendly,France,28,3,2015,-1,1,3,3714,0,0,Ghana,Senegal,5,1,0.41403,0.7298,12,loser,winner
Morocco,Uruguay,0,1,Friendly,Morocco,28,3,2015,-1,1,1,3715,0,1,Morocco,Uruguay,5,1,0.73338,0.53073,12,loser,winner
France,Denmark,2,0,Friendly,France,29,3,2015,2,-2,2,3716,0,1,France,Denmark,5,2,0.65745,0.092,12,winner,loser
Portugal,Serbia,2,1,UEFA Euro qualification,Portugal,29,3,2015,1,-1,3,3717,1,1,Portugal,Serbia,5,1,0.35747,0.56486,12,winner,loser
Netherlands,Spain,2,0,Friendly,Netherlands,31,3,2015,2,-2,2,3718,1,1,Netherlands,Spain,5,2,0.09663,0.29567,12,winner,loser
Switzerland,United States,1,1,Friendly,Switzerland,31,3,2015,0,0,2,3719,0,0,Switzerland,United_States,5,0,0.51653,0.80982,12,draw,draw
United States,Mexico,2,0,Friendly,United States,15,4,2015,2,-2,2,3720,0,1,United_States,Mexico,5,2,0.38892,0.42403,12,winner,loser
Netherlands,United States,3,4,Friendly,Netherlands,5,6,2015,-1,1,7,3721,1,0,Netherlands,United_States,5,1,0.14643,0.06061,12,loser,winner
Brazil,Mexico,2,0,Friendly,Brazil,7,6,2015,2,-2,2,3722,0,1,Brazil,Mexico,5,2,0.60762,0.29031,12,winner,loser
France,Belgium,3,4,Friendly,France,7,6,2015,-1,1,7,3723,0,1,France,Belgium,5,1,0.18173,0.16024,12,loser,winner
Germany,United States,1,2,Friendly,Germany,10,6,2015,-1,1,3,3724,1,0,Germany,United_States,5,1,0.62465,0.90898,12,loser,winner
Spain,Costa Rica,2,1,Friendly,Spain,11,6,2015,1,-1,3,3725,1,1,Spain,Costa_Rica,5,1,0.71892,0.33233,12,winner,loser
Wales,Belgium,1,0,UEFA Euro qualification,Wales,12,6,2015,1,-1,1,3726,0,1,Wales,Belgium,5,1,0.92649,0.27555,12,winner,loser
Denmark,Serbia,2,0,UEFA Euro qualification,Denmark,13,6,2015,2,-2,2,3727,1,1,Denmark,Serbia,5,2,0.30332,0.72378,12,winner,loser
Morocco,Tunisia,1,1,African Nations Championship,Morocco,15,6,2015,0,0,2,3728,0,1,Morocco,Tunisia,5,0,0.89818,0.27219,12,draw,draw
Argentina,Uruguay,1,0,Copa America,Chile,16,6,2015,1,-1,1,3729,1,1,Argentina,Uruguay,5,1,0.44189,0.38917,12,winner,loser
Mexico,Ecuador,1,2,Copa America,Chile,19,6,2015,-1,1,3,3730,1,0,Mexico,Ecuador,5,1,0.96531,0.22948,12,loser,winner
Mexico,Costa Rica,2,2,Friendly,United States,27,6,2015,0,0,4,3731,1,1,Mexico,Costa_Rica,5,0,0.82354,0.90026,12,draw,draw
Canada,Costa Rica,0,0,Gold Cup,Canada,14,7,2015,0,0,0,3732,0,1,Canada,Costa_Rica,5,0,0.04679,0.24295,12,draw,draw
Mexico,Costa Rica,1,0,Gold Cup,United States,19,7,2015,1,-1,1,3733,1,1,Mexico,Costa_Rica,5,1,0.84959,0.2709,12,winner,loser
Japan,South Korea,1,1,EAFF Championship,China PR,5,8,2015,0,0,2,3734,0,0,Japan,South_Korea,5,0,0.85961,0.98012,12,draw,draw
Germany,Poland,3,1,UEFA Euro qualification,Germany,4,9,2015,2,-2,4,3735,1,0,Germany,Poland,5,2,0.78245,0.19117,12,winner,loser
Portugal,France,0,1,Friendly,Portugal,4,9,2015,-1,1,1,3736,1,0,Portugal,France,5,1,0.52103,0.6495,12,loser,winner
Costa Rica,Brazil,0,1,Friendly,United States,5,9,2015,-1,1,1,3737,1,0,Costa_Rica,Brazil,5,1,0.11665,0.57124,12,loser,winner
France,Serbia,2,1,Friendly,France,7,9,2015,1,-1,3,3738,0,1,France,Serbia,5,1,0.17583,0.56418,12,winner,loser
England,Switzerland,2,0,UEFA Euro qualification,England,8,9,2015,2,-2,2,3739,1,0,England,Switzerland,5,2,0.69807,0.58669,12,winner,loser
Mexico,Argentina,2,2,Friendly,United States,8,9,2015,0,0,4,3740,1,1,Mexico,Argentina,5,0,0.93504,0.17048,12,draw,draw
Argentina,Ecuador,0,2,FIFA World Cup qualification,Argentina,8,10,2015,-2,2,2,3741,1,0,Argentina,Ecuador,5,2,0.82869,0.21493,12,loser,winner
Portugal,Denmark,1,0,UEFA Euro qualification,Portugal,8,10,2015,1,-1,1,3742,1,1,Portugal,Denmark,5,1,0.15034,0.94017,12,winner,loser
United States,Mexico,2,3,Friendly,United States,10,10,2015,-1,1,5,3743,0,1,United_States,Mexico,5,1,0.91157,0.11083,12,loser,winner
Denmark,France,1,2,Friendly,Denmark,11,10,2015,-1,1,3,3744,1,0,Denmark,France,5,1,0.2699,0.06672,12,loser,winner
Serbia,Portugal,1,2,UEFA Euro qualification,Serbia,11,10,2015,-1,1,3,3745,1,1,Serbia,Portugal,5,1,0.35504,0.33376,12,loser,winner
Iran,Japan,1,1,Friendly,Iran,13,10,2015,0,0,2,3746,1,0,Iran,Japan,5,0,0.14954,0.64428,12,draw,draw
Tunisia,Morocco,2,3,African Nations Championship,Tunisia,25,10,2015,-1,1,5,3747,1,0,Tunisia,Morocco,5,1,0.46346,0.73295,12,loser,winner
Ecuador,Uruguay,2,1,FIFA World Cup qualification,Ecuador,12,11,2015,1,-1,3,3748,0,1,Ecuador,Uruguay,5,1,0.72754,0.05185,12,winner,loser
Argentina,Brazil,1,1,FIFA World Cup qualification,Argentina,13,11,2015,0,0,2,3749,1,0,Argentina,Brazil,5,0,0.51554,0.84348,12,draw,draw
France,Germany,2,0,Friendly,France,13,11,2015,2,-2,2,3750,0,1,France,Germany,5,2,0.90992,0.02734,12,winner,loser
Spain,England,2,0,Friendly,Spain,13,11,2015,2,-2,2,3751,1,1,Spain,England,5,2,0.35239,0.51406,12,winner,loser
Wales,Netherlands,2,3,Friendly,Wales,13,11,2015,-1,1,5,3752,0,1,Wales,Netherlands,5,1,0.29339,0.98602,12,loser,winner
England,France,2,0,Friendly,England,17,11,2015,2,-2,2,3753,1,0,England,France,5,2,0.50706,0.5387,12,winner,loser
Poland,Serbia,1,0,Friendly,Poland,23,3,2016,1,-1,1,3754,0,1,Poland,Serbia,6,1,0.58262,0.99462,12,winner,loser
Brazil,Uruguay,2,2,FIFA World Cup qualification,Brazil,25,3,2016,0,0,4,3755,0,1,Brazil,Uruguay,6,0,0.40071,0.39555,12,draw,draw
Canada,Mexico,0,3,FIFA World Cup qualification,Canada,25,3,2016,-3,3,3,3756,0,1,Canada,Mexico,6,3,0.83787,0.62526,12,loser,winner
Netherlands,France,2,3,Friendly,Netherlands,25,3,2016,-1,1,5,3757,1,0,Netherlands,France,6,1,0.56277,0.54997,12,loser,winner
Germany,England,2,3,Friendly,Germany,26,3,2016,-1,1,5,3758,1,1,Germany,England,6,1,0.31879,0.86183,12,loser,winner
England,Netherlands,1,2,Friendly,England,29,3,2016,-1,1,3,3759,1,1,England,Netherlands,6,1,0.21853,0.80074,12,loser,winner
Mexico,Canada,2,0,FIFA World Cup qualification,Mexico,29,3,2016,2,-2,2,3760,1,0,Mexico,Canada,6,2,0.92992,0.70832,12,winner,loser
Portugal,Belgium,2,1,Friendly,Portugal,29,3,2016,1,-1,3,3761,1,1,Portugal,Belgium,6,1,0.59861,0.42819,12,winner,loser
England,Australia,2,1,Friendly,England,27,5,2016,1,-1,3,3762,1,0,England,Australia,6,1,0.72136,0.73034,12,winner,loser
Switzerland,Belgium,1,2,Friendly,Switzerland,28,5,2016,-1,1,3,3763,0,1,Switzerland,Belgium,6,1,0.44553,0.85526,12,loser,winner
France,Cameroon,3,2,Friendly,France,30,5,2016,1,-1,5,3764,0,1,France,Cameroon,6,1,0.29444,0.27535,12,winner,loser
Poland,Netherlands,1,2,Friendly,Poland,1,6,2016,-1,1,3,3765,0,1,Poland,Netherlands,6,1,0.17834,0.24196,12,loser,winner
Spain,South Korea,6,1,Friendly,Austria,1,6,2016,5,-5,7,3766,1,0,Spain,South_Korea,6,5,0.37328,0.27293,12,winner,loser
England,Portugal,1,0,Friendly,England,2,6,2016,1,-1,1,3767,1,1,England,Portugal,6,1,0.09102,0.96909,12,winner,loser
Brazil,Ecuador,0,0,Copa America,United States,4,6,2016,0,0,0,3768,0,0,Brazil,Ecuador,6,0,0.03591,0.93216,12,draw,draw
Mexico,Uruguay,3,1,Copa America,United States,5,6,2016,2,-2,4,3769,1,1,Mexico,Uruguay,6,2,0.53253,0.73434,12,winner,loser
United States,Costa Rica,4,0,Copa America,United States,7,6,2016,4,-4,4,3770,0,1,United_States,Costa_Rica,6,4,0.01223,0.61588,12,winner,loser
England,Wales,2,1,UEFA Euro,France,16,6,2016,1,-1,3,3771,1,0,England,Wales,6,1,0.86577,0.44328,12,winner,loser
Germany,Poland,0,0,UEFA Euro,France,16,6,2016,0,0,0,3772,1,0,Germany,Poland,6,0,0.04074,0.43541,12,draw,draw
United States,Ecuador,2,1,Copa America,United States,16,6,2016,1,-1,3,3773,0,0,United_States,Ecuador,6,1,0.4482,0.70906,12,winner,loser
France,Switzerland,0,0,UEFA Euro,France,19,6,2016,0,0,0,3774,0,0,France,Switzerland,6,0,0.45085,0.33693,12,draw,draw
Croatia,Spain,2,1,UEFA Euro,France,21,6,2016,1,-1,3,3775,0,1,Croatia,Spain,6,1,0.72451,0.14798,12,winner,loser
United States,Argentina,0,4,Copa America,United States,21,6,2016,-4,4,4,3776,0,1,United_States,Argentina,6,4,0.66852,0.48479,12,loser,winner
Croatia,Portugal,0,1,UEFA Euro,France,25,6,2016,-1,1,1,3777,0,1,Croatia,Portugal,6,1,0.4299,0.49634,12,loser,winner
Switzerland,Poland,1,1,UEFA Euro,France,25,6,2016,0,0,2,3778,0,0,Switzerland,Poland,6,0,0.24602,0.2523,12,draw,draw
Poland,Portugal,1,1,UEFA Euro,France,30,6,2016,0,0,2,3779,0,1,Poland,Portugal,6,0,0.04175,0.00879,12,draw,draw
Wales,Belgium,3,1,UEFA Euro,France,1,7,2016,2,-2,4,3780,0,1,Wales,Belgium,6,2,0.78113,0.43266,12,winner,loser
Portugal,Wales,2,0,UEFA Euro,France,6,7,2016,2,-2,2,3781,1,0,Portugal,Wales,6,2,0.55898,0.10818,12,winner,loser
France,Germany,2,0,UEFA Euro,France,7,7,2016,2,-2,2,3782,0,1,France,Germany,6,2,0.3319,0.8861,12,winner,loser
France,Portugal,0,1,UEFA Euro,France,10,7,2016,-1,1,1,3783,0,1,France,Portugal,6,1,0.15645,0.95715,12,loser,winner
Argentina,Uruguay,1,0,FIFA World Cup qualification,Argentina,1,9,2016,1,-1,1,3784,1,1,Argentina,Uruguay,6,1,0.95974,0.8819,12,winner,loser
Belgium,Spain,0,2,Friendly,Belgium,1,9,2016,-2,2,2,3785,1,1,Belgium,Spain,6,2,0.4043,0.84506,12,loser,winner
Ecuador,Brazil,0,3,FIFA World Cup qualification,Ecuador,1,9,2016,-3,3,3,3786,0,0,Ecuador,Brazil,6,3,0.30454,0.76432,12,loser,winner
Iran,Qatar,2,0,FIFA World Cup qualification,Iran,1,9,2016,2,-2,2,3787,1,0,Iran,Qatar,6,2,0.4171,0.28364,12,winner,loser
Switzerland,Portugal,2,0,FIFA World Cup qualification,Switzerland,6,9,2016,2,-2,2,3788,0,1,Switzerland,Portugal,6,2,0.59433,0.02821,12,winner,loser
Qatar,Serbia,3,0,Friendly,Qatar,29,9,2016,3,-3,3,3789,0,1,Qatar,Serbia,6,3,0.69973,0.68659,12,winner,loser
South Korea,Qatar,3,2,FIFA World Cup qualification,South Korea,6,10,2016,1,-1,5,3790,0,0,South_Korea,Qatar,6,1,0.25079,0.20879,12,winner,loser
Saudi Arabia,Australia,2,2,FIFA World Cup qualification,Saudi Arabia,6,10,2016,0,0,4,3791,1,0,Saudi_Arabia,Australia,6,0,0.20596,0.21629,12,draw,draw
Poland,Denmark,3,2,FIFA World Cup qualification,Poland,8,10,2016,1,-1,5,3792,0,1,Poland,Denmark,6,1,0.03368,0.35966,12,winner,loser
Netherlands,France,0,1,FIFA World Cup qualification,Netherlands,10,10,2016,-1,1,1,3793,1,0,Netherlands,France,6,1,0.58229,0.15601,12,loser,winner
Australia,Japan,1,1,FIFA World Cup qualification,Australia,11,10,2016,0,0,2,3794,0,0,Australia,Japan,6,0,0.43608,0.01342,12,draw,draw
Iran,South Korea,1,0,FIFA World Cup qualification,Iran,11,10,2016,1,-1,1,3795,1,0,Iran,South_Korea,6,1,0.10309,0.44963,12,winner,loser
Morocco,Canada,4,0,Friendly,Morocco,11,10,2016,4,-4,4,3796,0,0,Morocco,Canada,6,4,0.9474,0.89142,12,winner,loser
Netherlands,Belgium,1,1,Friendly,Netherlands,9,11,2016,0,0,2,3797,1,1,Netherlands,Belgium,6,0,0.82004,0.33774,12,draw,draw
Brazil,Argentina,3,0,FIFA World Cup qualification,Brazil,10,11,2016,3,-3,3,3798,0,1,Brazil,Argentina,6,3,0.05517,0.68627,12,winner,loser
Uruguay,Ecuador,2,1,FIFA World Cup qualification,Uruguay,10,11,2016,1,-1,3,3799,1,0,Uruguay,Ecuador,6,1,0.6166,0.66209,12,winner,loser
South Korea,Canada,2,0,Friendly,South Korea,11,11,2016,2,-2,2,3800,0,0,South_Korea,Canada,6,2,0.61507,0.62692,12,winner,loser
United States,Mexico,1,2,FIFA World Cup qualification,United States,11,11,2016,-1,1,3,3801,0,1,United_States,Mexico,6,1,0.39238,0.51296,12,loser,winner
Wales,Serbia,1,1,FIFA World Cup qualification,Wales,12,11,2016,0,0,2,3802,0,1,Wales,Serbia,6,0,0.32378,0.05016,12,draw,draw
Costa Rica,United States,4,0,FIFA World Cup qualification,Costa Rica,15,11,2016,4,-4,4,3803,1,0,Costa_Rica,United_States,6,4,0.38525,0.56056,12,winner,loser
England,Spain,2,2,Friendly,England,15,11,2016,0,0,4,3804,1,1,England,Spain,6,0,0.08091,0.9047,12,draw,draw
Japan,Saudi Arabia,2,1,FIFA World Cup qualification,Japan,15,11,2016,1,-1,3,3805,0,1,Japan,Saudi_Arabia,6,1,0.88276,0.3624,12,winner,loser
Tunisia,Senegal,0,2,African Cup of Nations,Gabon,15,1,2017,-2,2,2,3806,1,0,Tunisia,Senegal,7,2,0.96858,0.41665,12,loser,winner
Senegal,Cameroon,0,0,African Cup of Nations,Gabon,28,1,2017,0,0,0,3807,0,1,Senegal,Cameroon,7,0,0.05369,0.72321,12,draw,draw
United States,Serbia,0,0,Friendly,United States,29,1,2017,0,0,0,3808,0,1,United_States,Serbia,7,0,0.13493,0.47265,12,draw,draw
Cameroon,Ghana,2,0,African Cup of Nations,Gabon,2,2,2017,2,-2,2,3809,1,0,Cameroon,Ghana,7,2,0.97048,0.57244,12,winner,loser
Germany,England,1,0,Friendly,Germany,22,3,2017,1,-1,1,3810,1,1,Germany,England,7,1,0.19429,0.55648,12,winner,loser
Qatar,Iran,0,1,FIFA World Cup qualification,Qatar,23,3,2017,-1,1,1,3811,0,1,Qatar,Iran,7,1,0.2147,0.71998,12,loser,winner
Uruguay,Brazil,1,4,FIFA World Cup qualification,Uruguay,23,3,2017,-3,3,5,3812,1,0,Uruguay,Brazil,7,3,0.25979,0.40507,12,loser,winner
Mexico,Costa Rica,2,0,FIFA World Cup qualification,Mexico,24,3,2017,2,-2,2,3813,1,1,Mexico,Costa_Rica,7,2,0.46476,0.8991,12,winner,loser
Tunisia,Cameroon,0,1,Friendly,Tunisia,24,3,2017,-1,1,1,3814,1,1,Tunisia,Cameroon,7,1,0.03423,0.37957,12,loser,winner
France,Spain,0,2,Friendly,France,28,3,2017,-2,2,2,3815,0,1,France,Spain,7,2,0.43177,0.55069,12,loser,winner
Morocco,Tunisia,1,0,Friendly,Morocco,28,3,2017,1,-1,1,3816,0,1,Morocco,Tunisia,7,1,0.56593,0.53927,12,winner,loser
Mexico,Croatia,1,2,Friendly,United States,28,5,2017,-1,1,3,3817,1,0,Mexico,Croatia,7,1,0.93391,0.82928,12,loser,winner
Morocco,Netherlands,1,2,Friendly,Morocco,31,5,2017,-1,1,3,3818,0,1,Morocco,Netherlands,7,1,0.92251,0.54673,12,loser,winner
Denmark,Germany,1,1,Friendly,Denmark,6,6,2017,0,0,2,3819,1,1,Denmark,Germany,7,0,0.18841,0.05909,12,draw,draw
Australia,Saudi Arabia,3,2,FIFA World Cup qualification,Australia,8,6,2017,1,-1,5,3820,0,1,Australia,Saudi_Arabia,7,1,0.58421,0.86884,12,winner,loser
Argentina,Brazil,1,0,Supercl√°sico de las Am√©ricas,Australia,9,6,2017,1,-1,1,3821,1,0,Argentina,Brazil,7,1,0.01392,0.68473,12,winner,loser
Cameroon,Morocco,1,0,African Cup of Nations qualification,Cameroon,10,6,2017,1,-1,1,3822,1,0,Cameroon,Morocco,7,1,0.18347,0.08499,12,winner,loser
Mexico,United States,1,1,FIFA World Cup qualification,Mexico,11,6,2017,0,0,2,3823,1,0,Mexico,United_States,7,0,0.6193,0.85328,12,draw,draw
Serbia,Wales,1,1,FIFA World Cup qualification,Serbia,11,6,2017,0,0,2,3824,1,0,Serbia,Wales,7,0,0.23777,0.2525,12,draw,draw
Australia,Brazil,0,4,Friendly,Australia,13,6,2017,-4,4,4,3825,0,0,Australia,Brazil,7,4,0.93788,0.35912,12,loser,winner
France,England,3,2,Friendly,France,13,6,2017,1,-1,5,3826,0,1,France,England,7,1,0.88195,0.66972,12,winner,loser
Qatar,South Korea,3,2,FIFA World Cup qualification,Qatar,13,6,2017,1,-1,5,3827,0,0,Qatar,South_Korea,7,1,0.45579,0.2841,12,winner,loser
Portugal,Mexico,2,2,Confederations Cup,Russia,18,6,2017,0,0,4,3828,1,1,Portugal,Mexico,7,0,0.30278,0.807,12,draw,draw
Australia,Germany,2,3,Confederations Cup,Russia,19,6,2017,-1,1,5,3829,0,1,Australia,Germany,7,1,0.80537,0.92229,12,loser,winner
Cameroon,Australia,1,1,Confederations Cup,Russia,22,6,2017,0,0,2,3830,1,0,Cameroon,Australia,7,0,0.20804,0.13838,12,draw,draw
Germany,Cameroon,3,1,Confederations Cup,Russia,25,6,2017,2,-2,4,3831,1,1,Germany,Cameroon,7,2,0.95834,0.71019,12,winner,loser
Germany,Mexico,4,1,Confederations Cup,Russia,29,6,2017,3,-3,5,3832,1,1,Germany,Mexico,7,3,0.92292,0.29166,12,winner,loser
United States,Ghana,2,1,Friendly,United States,1,7,2017,1,-1,3,3833,0,0,United_States,Ghana,7,1,0.24467,0.47459,12,winner,loser
Portugal,Mexico,2,1,Confederations Cup,Russia,2,7,2017,1,-1,3,3834,1,1,Portugal,Mexico,7,1,0.46462,0.10536,12,winner,loser
Costa Rica,Canada,1,1,Gold Cup,United States,11,7,2017,0,0,2,3835,1,0,Costa_Rica,Canada,7,0,0.48655,0.20865,12,draw,draw
United States,Costa Rica,2,0,Gold Cup,United States,22,7,2017,2,-2,2,3836,0,1,United_States,Costa_Rica,7,2,0.36894,0.75301,12,winner,loser
Brazil,Ecuador,2,0,FIFA World Cup qualification,Brazil,31,8,2017,2,-2,2,3837,0,0,Brazil,Ecuador,7,2,0.32342,0.67683,12,winner,loser
France,Netherlands,4,0,FIFA World Cup qualification,France,31,8,2017,4,-4,4,3838,0,1,France,Netherlands,7,4,0.51767,0.93216,12,winner,loser
Japan,Australia,2,0,FIFA World Cup qualification,Japan,31,8,2017,2,-2,2,3839,0,0,Japan,Australia,7,2,0.30923,0.23437,12,winner,loser
South Korea,Iran,0,0,FIFA World Cup qualification,South Korea,31,8,2017,0,0,0,3840,0,1,South_Korea,Iran,7,0,0.49082,0.00351,12,draw,draw
Uruguay,Argentina,0,0,FIFA World Cup qualification,Uruguay,31,8,2017,0,0,0,3841,1,1,Uruguay,Argentina,7,0,0.61341,0.63805,12,draw,draw
Denmark,Poland,4,0,FIFA World Cup qualification,Denmark,1,9,2017,4,-4,4,3842,1,0,Denmark,Poland,7,4,0.91556,0.74803,12,winner,loser
United States,Costa Rica,0,2,FIFA World Cup qualification,United States,1,9,2017,-2,2,2,3843,0,1,United_States,Costa_Rica,7,2,0.73729,0.60871,12,loser,winner
Costa Rica,Mexico,1,1,FIFA World Cup qualification,Costa Rica,5,9,2017,0,0,2,3844,1,1,Costa_Rica,Mexico,7,0,0.6018,0.58769,12,draw,draw
Saudi Arabia,Japan,1,0,FIFA World Cup qualification,Saudi Arabia,5,9,2017,1,-1,1,3845,1,0,Saudi_Arabia,Japan,7,1,0.04552,0.03317,12,winner,loser
Ecuador,Argentina,1,3,FIFA World Cup qualification,Ecuador,10,10,2017,-2,2,4,3846,0,1,Ecuador,Argentina,7,2,0.67514,0.32095,12,loser,winner
South Korea,Morocco,1,3,Friendly,Switzerland,10,10,2017,-2,2,4,3847,0,0,South_Korea,Morocco,7,2,0.40569,0.50574,12,loser,winner
Portugal,Switzerland,2,0,FIFA World Cup qualification,Portugal,10,10,2017,2,-2,2,3848,1,0,Portugal,Switzerland,7,2,0.66437,0.7162,12,winner,loser
Saudi Arabia,Ghana,0,3,Friendly,Saudi Arabia,10,10,2017,-3,3,3,3849,1,0,Saudi_Arabia,Ghana,7,3,0.71719,0.16204,12,loser,winner
Belgium,Mexico,3,3,Friendly,Belgium,10,11,2017,0,0,6,3850,1,1,Belgium,Mexico,7,0,0.8574,0.13761,12,draw,draw
England,Germany,0,0,Friendly,England,10,11,2017,0,0,0,3851,1,1,England,Germany,7,0,0.26082,0.84528,12,draw,draw
France,Wales,2,0,Friendly,France,10,11,2017,2,-2,2,3852,0,0,France,Wales,7,2,0.79585,0.55463,12,winner,loser
Japan,Brazil,1,3,Friendly,France,10,11,2017,-2,2,4,3853,0,0,Japan,Brazil,7,2,0.14501,0.56079,12,loser,winner
Poland,Uruguay,0,0,Friendly,Poland,10,11,2017,0,0,0,3854,0,1,Poland,Uruguay,7,0,0.4359,0.3828,12,draw,draw
Portugal,Saudi Arabia,3,0,Friendly,Portugal,10,11,2017,3,-3,3,3855,1,1,Portugal,Saudi_Arabia,7,3,0.34273,0.01273,12,winner,loser
Spain,Costa Rica,5,0,Friendly,Spain,11,11,2017,5,-5,5,3856,1,1,Spain,Costa_Rica,7,5,0.56895,0.94951,12,winner,loser
Poland,Mexico,0,1,Friendly,Poland,13,11,2017,-1,1,1,3857,0,1,Poland,Mexico,7,1,0.56706,0.67884,12,loser,winner
Belgium,Japan,1,0,Friendly,Belgium,14,11,2017,1,-1,1,3858,1,0,Belgium,Japan,7,1,0.07755,0.14534,12,winner,loser
England,Brazil,0,0,Friendly,England,14,11,2017,0,0,0,3859,1,0,England,Brazil,7,0,0.63882,0.46306,12,draw,draw
Germany,France,2,2,Friendly,Germany,14,11,2017,0,0,4,3860,1,0,Germany,France,7,0,0.37036,0.03016,12,draw,draw
South Korea,Serbia,1,1,Friendly,South Korea,14,11,2017,0,0,2,3861,0,1,South_Korea,Serbia,7,0,0.73955,0.98775,12,draw,draw
Portugal,United States,1,1,Friendly,Portugal,14,11,2017,0,0,2,3862,1,0,Portugal,United_States,7,0,0.20523,0.67074,12,draw,draw
Japan,South Korea,1,4,EAFF Championship,Japan,16,12,2017,-3,3,5,3863,0,0,Japan,South_Korea,7,3,0.52024,0.88909,12,loser,winner
Germany,Spain,1,1,Friendly,Germany,23,3,2018,0,0,2,3864,1,1,Germany,Spain,8,0,0.44685,0.95492,12,draw,draw
Netherlands,England,0,1,Friendly,Netherlands,23,3,2018,-1,1,1,3865,1,1,Netherlands,England,8,1,0.6485,0.55153,12,loser,winner
Serbia,Morocco,1,2,Friendly,Italy,23,3,2018,-1,1,3,3866,1,0,Serbia,Morocco,8,1,0.04502,0.10195,12,loser,winner
Tunisia,Iran,1,0,Friendly,Tunisia,23,3,2018,1,-1,1,3867,1,1,Tunisia,Iran,8,1,0.7434,0.22001,12,winner,loser
Portugal,Netherlands,0,3,Friendly,Switzerland,26,3,2018,-3,3,3,3868,1,1,Portugal,Netherlands,8,3,0.66335,0.4774,12,loser,winner
Wales,Uruguay,0,1,Friendly,China PR,26,3,2018,-1,1,1,3869,0,1,Wales,Uruguay,8,1,0.7339,0.7238,12,loser,winner
Belgium,Saudi Arabia,4,0,Friendly,Belgium,27,3,2018,4,-4,4,3870,1,1,Belgium,Saudi_Arabia,8,4,0.42724,0.88892,12,winner,loser
Germany,Brazil,0,1,Friendly,Germany,27,3,2018,-1,1,1,3871,1,0,Germany,Brazil,8,1,0.01303,0.16864,12,loser,winner
Mexico,Croatia,0,1,Friendly,United States,27,3,2018,-1,1,1,3872,1,0,Mexico,Croatia,8,1,0.8069,0.63671,12,loser,winner
Poland,South Korea,3,2,Friendly,Poland,27,3,2018,1,-1,5,3873,0,0,Poland,South_Korea,8,1,0.65582,0.6061,12,winner,loser
Spain,Argentina,6,1,Friendly,Spain,27,3,2018,5,-5,7,3874,1,1,Spain,Argentina,8,5,0.62643,0.96067,12,winner,loser
Tunisia,Costa Rica,1,0,Friendly,France,27,3,2018,1,-1,1,3875,1,1,Tunisia,Costa_Rica,8,1,0.95896,0.70599,12,winner,loser
Portugal,Tunisia,2,2,Friendly,Portugal,28,5,2018,0,0,4,3876,1,1,Portugal,Tunisia,8,0,0.45046,0.39709,12,draw,draw
Mexico,Wales,0,0,Friendly,United States,28,5,2018,0,0,0,3877,1,0,Mexico,Wales,8,0,0.52948,0.92254,12,draw,draw
Japan,Ghana,0,2,Friendly,Japan,30,5,2018,-2,2,2,3878,0,0,Japan,Ghana,8,2,0.7981,0.54324,12,loser,winner
Belgium,Portugal,0,0,Friendly,Belgium,2,6,2018,0,0,0,3879,1,1,Belgium,Portugal,8,0,0.73552,0.7733,12,draw,draw
Spain,Switzerland,1,1,Friendly,Spain,3,6,2018,0,0,2,3880,1,0,Spain,Switzerland,8,0,0.99367,0.45646,12,draw,draw
Croatia,Brazil,0,2,Friendly,England,3,6,2018,-2,2,2,3881,0,0,Croatia,Brazil,8,2,0.46465,0.80842,12,loser,winner
England,Costa Rica,2,0,Friendly,England,7,6,2018,2,-2,2,3882,1,1,England,Costa_Rica,8,2,0.03224,0.51547,12,winner,loser
Germany,Saudi Arabia,2,1,Friendly,Germany,8,6,2018,1,-1,3,3883,1,1,Germany,Saudi_Arabia,8,1,0.80838,0.74916,12,winner,loser
Croatia,Senegal,2,1,Friendly,Croatia,8,6,2018,1,-1,3,3884,0,0,Croatia,Senegal,8,1,0.01941,0.08906,12,winner,loser
Switzerland,Japan,2,0,Friendly,Switzerland,8,6,2018,2,-2,2,3885,0,0,Switzerland,Japan,8,2,0.77399,0.34522,12,winner,loser
Denmark,Mexico,2,0,Friendly,Denmark,9,6,2018,2,-2,2,3886,1,1,Denmark,Mexico,8,2,0.07841,0.71984,12,winner,loser
Tunisia,Spain,0,1,Friendly,Russia,9,6,2018,-1,1,1,3887,1,1,Tunisia,Spain,8,1,0.66913,0.57891,12,loser,winner
France,United States,1,1,Friendly,France,9,6,2018,0,0,2,3888,0,0,France,United_States,8,0,0.07989,0.41514,12,draw,draw
South Korea,Senegal,0,2,Friendly,Austria,11,6,2018,-2,2,2,3889,0,0,South_Korea,Senegal,8,2,0.41467,0.238,12,loser,winner
Belgium,Costa Rica,4,1,Friendly,Belgium,11,6,2018,3,-3,5,3890,1,1,Belgium,Costa_Rica,8,3,0.15287,0.88138,12,winner,loser
Morocco,Iran,0,1,FIFA World Cup,Russia,15,6,2018,-1,1,1,3891,0,1,Morocco,Iran,8,1,0.60357,0.59813,12,loser,winner
Portugal,Spain,3,3,FIFA World Cup,Russia,15,6,2018,0,0,6,3892,1,1,Portugal,Spain,8,0,0.84701,0.33804,12,draw,draw
France,Australia,2,1,FIFA World Cup,Russia,16,6,2018,1,-1,3,3893,0,0,France,Australia,8,1,0.63366,0.5818,12,winner,loser
Costa Rica,Serbia,0,1,FIFA World Cup,Russia,17,6,2018,-1,1,1,3894,1,1,Costa_Rica,Serbia,8,1,0.5424,0.22285,12,loser,winner
Germany,Mexico,0,1,FIFA World Cup,Russia,17,6,2018,-1,1,1,3895,1,1,Germany,Mexico,8,1,0.39621,0.2516,12,loser,winner
Brazil,Switzerland,1,1,FIFA World Cup,Russia,17,6,2018,0,0,2,3896,0,0,Brazil,Switzerland,8,0,0.93001,0.1882,12,draw,draw
Tunisia,England,1,2,FIFA World Cup,Russia,18,6,2018,-1,1,3,3897,1,1,Tunisia,England,8,1,0.47057,0.21756,12,loser,winner
Poland,Senegal,1,2,FIFA World Cup,Russia,19,6,2018,-1,1,3,3898,0,0,Poland,Senegal,8,1,0.61743,0.38854,12,loser,winner
Portugal,Morocco,1,0,FIFA World Cup,Russia,20,6,2018,1,-1,1,3899,1,0,Portugal,Morocco,8,1,0.12484,0.69139,12,winner,loser
Uruguay,Saudi Arabia,1,0,FIFA World Cup,Russia,20,6,2018,1,-1,1,3900,1,1,Uruguay,Saudi_Arabia,8,1,0.19958,0.73855,12,winner,loser
Iran,Spain,0,1,FIFA World Cup,Russia,20,6,2018,-1,1,1,3901,1,1,Iran,Spain,8,1,0.18049,0.18122,12,loser,winner
Denmark,Australia,1,1,FIFA World Cup,Russia,21,6,2018,0,0,2,3902,1,0,Denmark,Australia,8,0,0.00347,0.11083,12,draw,draw
Argentina,Croatia,0,3,FIFA World Cup,Russia,21,6,2018,-3,3,3,3903,1,0,Argentina,Croatia,8,3,0.438,0.59711,12,loser,winner
Brazil,Costa Rica,2,0,FIFA World Cup,Russia,22,6,2018,2,-2,2,3904,0,1,Brazil,Costa_Rica,8,2,0.10055,0.61472,12,winner,loser
Serbia,Switzerland,1,2,FIFA World Cup,Russia,22,6,2018,-1,1,3,3905,1,0,Serbia,Switzerland,8,1,0.04694,0.66212,12,loser,winner
Belgium,Tunisia,5,2,FIFA World Cup,Russia,23,6,2018,3,-3,7,3906,1,1,Belgium,Tunisia,8,3,0.57392,0.271,12,winner,loser
South Korea,Mexico,1,2,FIFA World Cup,Russia,23,6,2018,-1,1,3,3907,0,1,South_Korea,Mexico,8,1,4.00E-05,0.43115,12,loser,winner
Japan,Senegal,2,2,FIFA World Cup,Russia,24,6,2018,0,0,4,3908,0,0,Japan,Senegal,8,0,0.33995,0.60739,12,draw,draw
Spain,Morocco,2,2,FIFA World Cup,Russia,25,6,2018,0,0,4,3909,1,0,Spain,Morocco,8,0,0.96098,0.85685,12,draw,draw
Iran,Portugal,1,1,FIFA World Cup,Russia,25,6,2018,0,0,2,3910,1,1,Iran,Portugal,8,0,0.43267,0.12049,12,draw,draw
Denmark,France,0,0,FIFA World Cup,Russia,26,6,2018,0,0,0,3911,1,0,Denmark,France,8,0,0.82386,0.17352,12,draw,draw
South Korea,Germany,2,0,FIFA World Cup,Russia,27,6,2018,2,-2,2,3912,0,1,South_Korea,Germany,8,2,0.66743,0.38208,12,winner,loser
Serbia,Brazil,0,2,FIFA World Cup,Russia,27,6,2018,-2,2,2,3913,1,0,Serbia,Brazil,8,2,0.51664,0.50978,12,loser,winner
Switzerland,Costa Rica,2,2,FIFA World Cup,Russia,27,6,2018,0,0,4,3914,0,1,Switzerland,Costa_Rica,8,0,0.02369,0.26112,12,draw,draw
Japan,Poland,0,1,FIFA World Cup,Russia,28,6,2018,-1,1,1,3915,0,0,Japan,Poland,8,1,0.54796,0.41563,12,loser,winner
England,Belgium,0,1,FIFA World Cup,Russia,28,6,2018,-1,1,1,3916,1,1,England,Belgium,8,1,0.87136,0.92888,12,loser,winner
France,Argentina,4,3,FIFA World Cup,Russia,30,6,2018,1,-1,7,3917,0,1,France,Argentina,8,1,0.4536,0.48422,12,winner,loser
Uruguay,Portugal,2,1,FIFA World Cup,Russia,30,6,2018,1,-1,3,3918,1,1,Uruguay,Portugal,8,1,0.15277,0.40901,12,winner,loser
Croatia,Denmark,1,1,FIFA World Cup,Russia,1,7,2018,0,0,2,3919,0,1,Croatia,Denmark,8,0,0.02329,0.54819,12,draw,draw
Brazil,Mexico,2,0,FIFA World Cup,Russia,2,7,2018,2,-2,2,3920,0,1,Brazil,Mexico,8,2,0.87514,0.04471,12,winner,loser
Belgium,Japan,3,2,FIFA World Cup,Russia,2,7,2018,1,-1,5,3921,1,0,Belgium,Japan,8,1,0.56209,0.88173,12,winner,loser
Uruguay,France,0,2,FIFA World Cup,Russia,6,7,2018,-2,2,2,3922,1,0,Uruguay,France,8,2,0.28717,0.90266,12,loser,winner
Brazil,Belgium,1,2,FIFA World Cup,Russia,6,7,2018,-1,1,3,3923,0,1,Brazil,Belgium,8,1,0.89147,0.56984,12,loser,winner
France,Belgium,1,0,FIFA World Cup,Russia,10,7,2018,1,-1,1,3924,0,1,France,Belgium,8,1,0.3976,0.75479,12,winner,loser
Croatia,England,2,1,FIFA World Cup,Russia,11,7,2018,1,-1,3,3925,0,1,Croatia,England,8,1,0.96727,0.92185,12,winner,loser
Belgium,England,2,0,FIFA World Cup,Russia,14,7,2018,2,-2,2,3926,1,1,Belgium,England,8,2,0.02035,0.84394,12,winner,loser
France,Croatia,4,2,FIFA World Cup,Russia,15,7,2018,2,-2,6,3927,0,0,France,Croatia,8,2,0.30947,0.95959,12,winner,loser
Germany,France,0,0,UEFA Nations League,Germany,6,9,2018,0,0,0,3928,1,0,Germany,France,8,0,0.76052,0.21806,12,draw,draw
Portugal,Croatia,1,1,Friendly,Portugal,6,9,2018,0,0,2,3929,1,0,Portugal,Croatia,8,0,0.01759,0.85664,12,draw,draw
South Korea,Costa Rica,2,0,Friendly,South Korea,7,9,2018,2,-2,2,3930,0,1,South_Korea,Costa_Rica,8,2,0.73431,0.96074,12,winner,loser
Mexico,Uruguay,1,4,Friendly,United States,7,9,2018,-3,3,5,3931,1,1,Mexico,Uruguay,8,3,0.8319,0.40133,12,loser,winner
United States,Brazil,0,2,Friendly,United States,7,9,2018,-2,2,2,3932,0,0,United_States,Brazil,8,2,0.0898,0.03502,12,loser,winner
England,Spain,1,2,UEFA Nations League,England,8,9,2018,-1,1,3,3933,1,1,England,Spain,8,1,0.06043,0.97143,12,loser,winner
France,Netherlands,2,1,UEFA Nations League,France,9,9,2018,1,-1,3,3934,0,1,France,Netherlands,8,1,0.36893,0.3438,12,winner,loser
Denmark,Wales,2,0,UEFA Nations League,Denmark,9,9,2018,2,-2,2,3935,1,0,Denmark,Wales,8,2,0.2959,0.31792,12,winner,loser
Spain,Croatia,6,0,UEFA Nations League,Spain,11,9,2018,6,-6,6,3936,1,0,Spain,Croatia,8,6,0.5028,0.99416,12,winner,loser
England,Switzerland,1,0,Friendly,England,11,9,2018,1,-1,1,3937,1,0,England,Switzerland,8,1,0.38996,0.93137,12,winner,loser
Japan,Costa Rica,3,0,Kirin Challenge Cup,Japan,11,9,2018,3,-3,3,3938,0,1,Japan,Costa_Rica,8,3,0.78045,0.9935,12,winner,loser
United States,Mexico,1,0,Friendly,United States,11,9,2018,1,-1,1,3939,0,1,United_States,Mexico,8,1,0.62762,0.64834,12,winner,loser
Poland,Portugal,2,3,UEFA Nations League,Poland,11,10,2018,-1,1,5,3940,0,1,Poland,Portugal,8,1,0.52879,0.74444,12,loser,winner
Mexico,Costa Rica,3,2,Friendly,Mexico,11,10,2018,1,-1,5,3941,1,1,Mexico,Costa_Rica,8,1,0.40375,0.97762,12,winner,loser
Wales,Spain,1,4,Friendly,Wales,11,10,2018,-3,3,5,3942,0,1,Wales,Spain,8,3,0.91728,0.5906,12,loser,winner
Belgium,Switzerland,2,1,UEFA Nations League,Belgium,12,10,2018,1,-1,3,3943,1,0,Belgium,Switzerland,8,1,0.07599,0.53834,12,winner,loser
Croatia,England,0,0,UEFA Nations League,Croatia,12,10,2018,0,0,0,3944,0,1,Croatia,England,8,0,0.26474,0.17255,12,draw,draw
South Korea,Uruguay,2,1,Friendly,South Korea,12,10,2018,1,-1,3,3945,0,1,South_Korea,Uruguay,8,1,0.05523,0.3866,12,winner,loser
Qatar,Ecuador,4,3,Friendly,Qatar,12,10,2018,1,-1,7,3946,0,0,Qatar,Ecuador,8,1,0.76179,0.94186,12,winner,loser
Saudi Arabia,Brazil,0,2,Friendly,Saudi Arabia,12,10,2018,-2,2,2,3947,1,0,Saudi_Arabia,Brazil,8,2,0.01404,0.55675,12,loser,winner
Netherlands,Germany,3,0,UEFA Nations League,Netherlands,13,10,2018,3,-3,3,3948,1,1,Netherlands,Germany,8,3,0.20244,0.93645,12,winner,loser
Spain,England,2,3,UEFA Nations League,Spain,15,10,2018,-1,1,5,3949,1,1,Spain,England,8,1,0.28801,0.60034,12,loser,winner
France,Germany,2,1,UEFA Nations League,France,16,10,2018,1,-1,3,3950,0,1,France,Germany,8,1,0.4123,0.07839,12,winner,loser
Belgium,Netherlands,1,1,Friendly,Belgium,16,10,2018,0,0,2,3951,1,1,Belgium,Netherlands,8,0,0.40704,0.93944,12,draw,draw
Japan,Uruguay,4,3,Kirin Challenge Cup,Japan,16,10,2018,1,-1,7,3952,0,1,Japan,Uruguay,8,1,0.20586,0.65795,12,winner,loser
Argentina,Brazil,0,1,Supercl√°sico de las Am√©ricas,Saudi Arabia,16,10,2018,-1,1,1,3953,1,0,Argentina,Brazil,8,1,0.8256,0.47812,12,loser,winner
Switzerland,Qatar,0,1,Friendly,Switzerland,14,11,2018,-1,1,1,3954,0,0,Switzerland,Qatar,8,1,0.32588,0.36882,12,loser,winner
Croatia,Spain,3,2,UEFA Nations League,Croatia,15,11,2018,1,-1,5,3955,0,1,Croatia,Spain,8,1,0.58924,0.5321,12,winner,loser
England,United States,3,0,Friendly,England,15,11,2018,3,-3,3,3956,1,0,England,United_States,8,3,0.898,0.57693,12,winner,loser
Netherlands,France,2,0,UEFA Nations League,Netherlands,16,11,2018,2,-2,2,3957,1,0,Netherlands,France,8,2,0.84139,0.23051,12,winner,loser
Wales,Denmark,1,2,UEFA Nations League,Wales,16,11,2018,-1,1,3,3958,0,1,Wales,Denmark,8,1,0.77798,0.7183,12,loser,winner
Argentina,Mexico,2,0,Friendly,Argentina,16,11,2018,2,-2,2,3959,1,1,Argentina,Mexico,8,2,0.62475,0.07586,12,winner,loser
Brazil,Uruguay,1,0,Friendly,England,16,11,2018,1,-1,1,3960,0,1,Brazil,Uruguay,8,1,0.67201,0.7891,12,winner,loser
Morocco,Cameroon,2,0,African Cup of Nations qualification,Morocco,16,11,2018,2,-2,2,3961,0,1,Morocco,Cameroon,8,2,0.24483,0.43888,12,winner,loser
Australia,South Korea,1,1,Friendly,Australia,17,11,2018,0,0,2,3962,0,0,Australia,South_Korea,8,0,0.8846,0.80644,12,draw,draw
Switzerland,Belgium,5,2,UEFA Nations League,Switzerland,18,11,2018,3,-3,7,3963,0,1,Switzerland,Belgium,8,3,0.55875,0.44603,12,winner,loser
England,Croatia,2,1,UEFA Nations League,England,18,11,2018,1,-1,3,3964,1,0,England,Croatia,8,1,0.1734,0.99843,12,winner,loser
Germany,Netherlands,2,2,UEFA Nations League,Germany,19,11,2018,0,0,4,3965,1,1,Germany,Netherlands,8,0,0.36854,0.67058,12,draw,draw
Portugal,Poland,1,1,UEFA Nations League,Portugal,20,11,2018,0,0,2,3966,1,0,Portugal,Poland,8,0,0.6609,0.49217,12,draw,draw
Argentina,Mexico,2,0,Friendly,Argentina,20,11,2018,2,-2,2,3967,1,1,Argentina,Mexico,8,2,0.51063,0.60968,12,winner,loser
Brazil,Cameroon,1,0,Friendly,England,20,11,2018,1,-1,1,3968,0,1,Brazil,Cameroon,8,1,0.23093,0.79559,12,winner,loser
France,Uruguay,1,0,Friendly,France,20,11,2018,1,-1,1,3969,0,1,France,Uruguay,8,1,0.73011,0.8466,12,winner,loser
Tunisia,Morocco,0,1,Friendly,Tunisia,20,11,2018,-1,1,1,3970,1,0,Tunisia,Morocco,8,1,0.4209,0.35787,12,loser,winner
South Korea,Saudi Arabia,0,0,Friendly,United Arab Emirates,31,12,2018,0,0,0,3971,0,1,South_Korea,Saudi_Arabia,8,0,0.50658,0.36034,12,draw,draw
Qatar,Iran,1,2,Friendly,Qatar,31,12,2018,-1,1,3,3972,0,1,Qatar,Iran,8,1,0.67636,0.49362,12,loser,winner
Saudi Arabia,Qatar,0,2,AFC Asian Cup,United Arab Emirates,17,1,2019,-2,2,2,3973,1,0,Saudi_Arabia,Qatar,9,2,0.66342,0.77619,12,loser,winner
Japan,Saudi Arabia,1,0,AFC Asian Cup,United Arab Emirates,21,1,2019,1,-1,1,3974,0,1,Japan,Saudi_Arabia,9,1,0.49954,0.02888,12,winner,loser
South Korea,Qatar,0,1,AFC Asian Cup,United Arab Emirates,25,1,2019,-1,1,1,3975,0,0,South_Korea,Qatar,9,1,0.96976,0.82959,12,loser,winner
Iran,Japan,0,3,AFC Asian Cup,United Arab Emirates,28,1,2019,-3,3,3,3976,1,0,Iran,Japan,9,3,0.27294,0.0397,12,loser,winner
Japan,Qatar,1,3,AFC Asian Cup,United Arab Emirates,1,2,2019,-2,2,4,3977,0,0,Japan,Qatar,9,2,0.44717,0.88486,12,loser,winner
United States,Costa Rica,2,0,Friendly,United States,2,2,2019,2,-2,2,3978,0,1,United_States,Costa_Rica,9,2,0.6665,0.17301,12,winner,loser
Germany,Serbia,1,1,Friendly,Germany,20,3,2019,0,0,2,3979,1,1,Germany,Serbia,9,0,0.33848,0.89529,12,draw,draw
United States,Ecuador,1,0,Friendly,United States,21,3,2019,1,-1,1,3980,0,0,United_States,Ecuador,9,1,0.30854,0.72683,12,winner,loser
Netherlands,Germany,2,3,UEFA Euro qualification,Netherlands,24,3,2019,-1,1,5,3981,1,1,Netherlands,Germany,9,1,0.79501,0.31428,12,loser,winner
Portugal,Serbia,1,1,UEFA Euro qualification,Portugal,25,3,2019,0,0,2,3982,1,1,Portugal,Serbia,9,0,0.29609,0.38262,12,draw,draw
Morocco,Argentina,0,1,Friendly,Morocco,26,3,2019,-1,1,1,3983,0,1,Morocco,Argentina,9,1,0.77704,0.62234,12,loser,winner
Switzerland,Denmark,3,3,UEFA Euro qualification,Switzerland,26,3,2019,0,0,6,3984,0,1,Switzerland,Denmark,9,0,0.67069,0.0047,12,draw,draw
Brazil,Qatar,2,0,Friendly,Brazil,5,6,2019,2,-2,2,3985,0,0,Brazil,Qatar,9,2,0.87486,0.61777,12,winner,loser
Portugal,Switzerland,3,1,UEFA Nations League,Portugal,5,6,2019,2,-2,4,3986,1,0,Portugal,Switzerland,9,2,0.03255,0.99106,12,winner,loser
England,Netherlands,1,3,UEFA Nations League,Portugal,6,6,2019,-2,2,4,3987,1,1,England,Netherlands,9,2,0.03719,0.188,12,loser,winner
South Korea,Australia,1,0,Friendly,South Korea,7,6,2019,1,-1,1,3988,0,0,South_Korea,Australia,9,1,0.54653,0.3119,12,winner,loser
Croatia,Wales,2,1,UEFA Euro qualification,Croatia,8,6,2019,1,-1,3,3989,0,0,Croatia,Wales,9,1,0.3056,0.21291,12,winner,loser
Mexico,Ecuador,3,2,Friendly,United States,9,6,2019,1,-1,5,3990,1,0,Mexico,Ecuador,9,1,0.17538,0.51462,12,winner,loser
Switzerland,England,0,0,UEFA Nations League,Portugal,9,6,2019,0,0,0,3991,0,1,Switzerland,England,9,0,0.79952,0.08129,12,draw,draw
Portugal,Netherlands,1,0,UEFA Nations League,Portugal,9,6,2019,1,-1,1,3992,1,1,Portugal,Netherlands,9,1,0.71614,0.02064,12,winner,loser
Croatia,Tunisia,1,2,Friendly,Croatia,11,6,2019,-1,1,3,3993,0,1,Croatia,Tunisia,9,1,0.61077,0.37348,12,loser,winner
South Korea,Iran,1,1,Friendly,South Korea,11,6,2019,0,0,2,3994,0,1,South_Korea,Iran,9,0,0.35287,0.89986,12,draw,draw
Uruguay,Ecuador,4,0,Copa America,Brazil,16,6,2019,4,-4,4,3995,1,0,Uruguay,Ecuador,9,4,0.84794,0.35786,12,winner,loser
Mexico,Canada,3,1,Gold Cup,United States,19,6,2019,2,-2,4,3996,1,0,Mexico,Canada,9,2,0.84783,0.5863,12,winner,loser
Uruguay,Japan,2,2,Copa America,Brazil,20,6,2019,0,0,4,3997,1,0,Uruguay,Japan,9,0,0.56294,0.76289,12,draw,draw
Qatar,Argentina,0,2,Copa America,Brazil,23,6,2019,-2,2,2,3998,0,1,Qatar,Argentina,9,2,0.08706,0.77128,12,loser,winner
Ecuador,Japan,1,1,Copa America,Brazil,24,6,2019,0,0,2,3999,0,0,Ecuador,Japan,9,0,0.64468,0.20045,12,draw,draw
Cameroon,Ghana,0,0,African Cup of Nations,Egypt,29,6,2019,0,0,0,4000,1,0,Cameroon,Ghana,9,0,0.96207,0.7105,12,draw,draw
Mexico,Costa Rica,1,1,Gold Cup,United States,29,6,2019,0,0,2,4001,1,1,Mexico,Costa_Rica,9,0,0.66057,0.26419,12,draw,draw
Brazil,Argentina,2,0,Copa America,Brazil,2,7,2019,2,-2,2,4002,0,1,Brazil,Argentina,9,2,0.5422,0.44434,12,winner,loser
United States,Mexico,0,1,Gold Cup,United States,7,7,2019,-1,1,1,4003,0,1,United_States,Mexico,9,1,0.55793,0.92868,12,loser,winner
Ghana,Tunisia,1,1,African Cup of Nations,Egypt,8,7,2019,0,0,2,4004,0,1,Ghana,Tunisia,9,0,0.0269,0.50889,12,draw,draw
Senegal,Tunisia,1,0,African Cup of Nations,Egypt,14,7,2019,1,-1,1,4005,0,1,Senegal,Tunisia,9,1,0.60443,0.21573,12,winner,loser
Costa Rica,Uruguay,1,2,Friendly,Costa Rica,6,9,2019,-1,1,3,4006,1,1,Costa_Rica,Uruguay,9,1,0.43658,0.26423,12,loser,winner
United States,Mexico,0,3,Friendly,United States,6,9,2019,-3,3,3,4007,0,1,United_States,Mexico,9,3,0.76281,0.63801,12,loser,winner
Germany,Netherlands,2,4,UEFA Euro qualification,Germany,6,9,2019,-2,2,6,4008,1,1,Germany,Netherlands,9,2,0.44747,0.90813,12,loser,winner
Serbia,Portugal,2,4,UEFA Euro qualification,Serbia,7,9,2019,-2,2,6,4009,1,1,Serbia,Portugal,9,2,0.19394,0.97216,12,loser,winner
Argentina,Mexico,4,0,Friendly,United States,10,9,2019,4,-4,4,4010,1,1,Argentina,Mexico,9,4,0.50406,0.50405,12,winner,loser
United States,Uruguay,1,1,Friendly,United States,10,9,2019,0,0,2,4011,0,1,United_States,Uruguay,9,0,0.58798,0.96875,12,draw,draw
Germany,Argentina,2,2,Friendly,Germany,9,10,2019,0,0,4,4012,1,1,Germany,Argentina,9,0,0.76797,0.07502,12,draw,draw
Brazil,Senegal,1,1,Friendly,Singapore,10,10,2019,0,0,2,4013,0,0,Brazil,Senegal,9,0,0.79069,0.89544,12,draw,draw
Denmark,Switzerland,1,0,UEFA Euro qualification,Denmark,12,10,2019,1,-1,1,4014,1,0,Denmark,Switzerland,9,1,0.68616,0.37367,12,winner,loser
Tunisia,Cameroon,0,0,Friendly,Tunisia,12,10,2019,0,0,0,4015,1,1,Tunisia,Cameroon,9,0,0.77209,0.6027,12,draw,draw
Wales,Croatia,1,1,UEFA Euro qualification,Wales,13,10,2019,0,0,2,4016,0,0,Wales,Croatia,9,0,0.1638,0.01156,12,draw,draw
Ecuador,Argentina,1,6,Friendly,Spain,13,10,2019,-5,5,7,4017,0,1,Ecuador,Argentina,9,5,0.48078,0.42512,12,loser,winner
Canada,United States,2,0,CONCACAF Nations League,Canada,15,10,2019,2,-2,2,4018,0,0,Canada,United_States,9,2,0.71855,0.80713,12,winner,loser
Brazil,Argentina,0,1,Supercl√°sico de las Am√©ricas,Saudi Arabia,15,11,2019,-1,1,1,4019,0,1,Brazil,Argentina,9,1,0.24036,0.91014,12,loser,winner
United States,Canada,4,1,CONCACAF Nations League,United States,15,11,2019,3,-3,5,4020,0,0,United_States,Canada,9,3,0.18062,0.28199,12,winner,loser
Argentina,Uruguay,2,2,Friendly,Israel,18,11,2019,0,0,4,4021,1,1,Argentina,Uruguay,9,0,0.75453,0.52065,12,draw,draw
Brazil,South Korea,3,0,Friendly,United Arab Emirates,19,11,2019,3,-3,3,4022,0,0,Brazil,South_Korea,9,3,0.20729,0.21061,12,winner,loser
Qatar,Saudi Arabia,0,1,Gulf Cup,Qatar,5,12,2019,-1,1,1,4023,0,1,Qatar,Saudi_Arabia,9,1,0.3222,0.70465,12,loser,winner
South Korea,Japan,1,0,EAFF Championship,South Korea,18,12,2019,1,-1,1,4024,0,0,South_Korea,Japan,9,1,0.48148,0.99506,12,winner,loser
United States,Costa Rica,1,0,Friendly,United States,1,2,2020,1,-1,1,4025,0,1,United_States,Costa_Rica,0,1,0.10928,0.45413,13,winner,loser
Germany,Spain,1,1,UEFA Nations League,Germany,3,9,2020,0,0,2,4026,1,1,Germany,Spain,0,0,0.26585,0.17823,13,draw,draw
Netherlands,Poland,1,0,UEFA Nations League,Netherlands,4,9,2020,1,-1,1,4027,1,0,Netherlands,Poland,0,1,0.3231,0.7243,13,winner,loser
Denmark,Belgium,0,2,UEFA Nations League,Denmark,5,9,2020,-2,2,2,4028,1,1,Denmark,Belgium,0,2,0.51423,0.39132,13,loser,winner
Portugal,Croatia,4,1,UEFA Nations League,Portugal,5,9,2020,3,-3,5,4029,1,0,Portugal,Croatia,0,3,0.16855,0.486,13,winner,loser
Switzerland,Germany,1,1,UEFA Nations League,Switzerland,6,9,2020,0,0,2,4030,0,1,Switzerland,Germany,0,0,0.08613,0.46348,13,draw,draw
Denmark,England,0,0,UEFA Nations League,Denmark,8,9,2020,0,0,0,4031,1,1,Denmark,England,0,0,0.83264,0.45417,13,draw,draw
France,Croatia,4,2,UEFA Nations League,France,8,9,2020,2,-2,6,4032,0,0,France,Croatia,0,2,0.99881,0.59078,13,winner,loser
Netherlands,Mexico,0,1,Friendly,Netherlands,7,10,2020,-1,1,1,4033,1,1,Netherlands,Mexico,0,1,0.09165,0.83502,13,loser,winner
Portugal,Spain,0,0,Friendly,Portugal,7,10,2020,0,0,0,4034,1,1,Portugal,Spain,0,0,0.4557,0.13487,13,draw,draw
Switzerland,Croatia,1,2,Friendly,Switzerland,7,10,2020,-1,1,3,4035,0,0,Switzerland,Croatia,0,1,0.06153,0.64657,13,loser,winner
England,Wales,3,0,Friendly,England,8,10,2020,3,-3,3,4036,1,0,England,Wales,0,3,0.7068,0.64012,13,winner,loser
Argentina,Ecuador,1,0,FIFA World Cup qualification,Argentina,8,10,2020,1,-1,1,4037,1,0,Argentina,Ecuador,0,1,0.82744,0.59311,13,winner,loser
Japan,Cameroon,0,0,Friendly,Netherlands,9,10,2020,0,0,0,4038,0,1,Japan,Cameroon,0,0,0.16723,0.73915,13,draw,draw
Morocco,Senegal,3,1,Friendly,Morocco,9,10,2020,2,-2,4,4039,0,0,Morocco,Senegal,0,2,0.25539,0.48799,13,winner,loser
Spain,Switzerland,1,0,UEFA Nations League,Spain,10,10,2020,1,-1,1,4040,1,0,Spain,Switzerland,0,1,0.43844,0.90553,13,winner,loser
England,Belgium,2,1,UEFA Nations League,England,11,10,2020,1,-1,3,4041,1,1,England,Belgium,0,1,0.01733,0.43883,13,winner,loser
France,Portugal,0,0,UEFA Nations League,France,11,10,2020,0,0,0,4042,0,1,France,Portugal,0,0,0.32104,0.83688,13,draw,draw
Ghana,Qatar,5,1,Friendly,Turkey,12,10,2020,4,-4,6,4043,0,0,Ghana,Qatar,0,4,0.02762,0.30224,13,winner,loser
Germany,Switzerland,3,3,UEFA Nations League,Germany,13,10,2020,0,0,6,4044,1,0,Germany,Switzerland,0,0,0.29906,1.20E-04,13,draw,draw
Ecuador,Uruguay,4,2,FIFA World Cup qualification,Ecuador,13,10,2020,2,-2,6,4045,0,1,Ecuador,Uruguay,0,2,0.07867,0.87731,13,winner,loser
England,Denmark,0,1,UEFA Nations League,England,14,10,2020,-1,1,1,4046,1,1,England,Denmark,0,1,0.52923,0.80361,13,loser,winner
Croatia,France,1,2,UEFA Nations League,Croatia,14,10,2020,-1,1,3,4047,0,0,Croatia,France,0,1,0.17563,0.71704,13,loser,winner
Belgium,Switzerland,2,1,Friendly,Belgium,11,11,2020,1,-1,3,4048,1,0,Belgium,Switzerland,0,1,0.13855,0.86261,13,winner,loser
Netherlands,Spain,1,1,Friendly,Netherlands,11,11,2020,0,0,2,4049,1,1,Netherlands,Spain,0,0,0.66832,0.63163,13,draw,draw
Wales,United States,0,0,Friendly,Wales,12,11,2020,0,0,0,4050,0,0,Wales,United_States,0,0,0.53781,0.01237,13,draw,draw
Costa Rica,Qatar,1,1,Friendly,Austria,13,11,2020,0,0,2,4051,1,0,Costa_Rica,Qatar,0,0,0.09176,0.7928,13,draw,draw
Portugal,France,0,1,UEFA Nations League,Portugal,14,11,2020,-1,1,1,4052,1,0,Portugal,France,0,1,0.37733,0.08841,13,loser,winner
Switzerland,Spain,1,1,UEFA Nations League,Switzerland,14,11,2020,0,0,2,4053,0,1,Switzerland,Spain,0,0,0.20301,0.02754,13,draw,draw
Mexico,South Korea,3,2,Friendly,Austria,14,11,2020,1,-1,5,4054,1,0,Mexico,South_Korea,0,1,0.82465,0.13885,13,winner,loser
Belgium,England,2,0,UEFA Nations League,Belgium,15,11,2020,2,-2,2,4055,1,1,Belgium,England,0,2,0.32979,0.72273,13,winner,loser
Croatia,Portugal,2,3,UEFA Nations League,Croatia,17,11,2020,-1,1,5,4056,0,1,Croatia,Portugal,0,1,0.9349,0.70152,13,loser,winner
Spain,Germany,6,0,UEFA Nations League,Spain,17,11,2020,6,-6,6,4057,1,1,Spain,Germany,0,6,0.78746,0.68877,13,winner,loser
Japan,Mexico,0,2,Friendly,Austria,17,11,2020,-2,2,2,4058,0,1,Japan,Mexico,0,2,0.70718,0.88878,13,loser,winner
South Korea,Qatar,2,1,Friendly,Austria,17,11,2020,1,-1,3,4059,0,0,South_Korea,Qatar,0,1,0.9288,0.47147,13,winner,loser
Uruguay,Brazil,0,2,FIFA World Cup qualification,Uruguay,17,11,2020,-2,2,2,4060,1,0,Uruguay,Brazil,0,2,0.22784,0.44733,13,loser,winner
Poland,Netherlands,1,2,UEFA Nations League,Poland,18,11,2020,-1,1,3,4061,0,1,Poland,Netherlands,0,1,0.42283,0.06027,13,loser,winner
Belgium,Denmark,4,2,UEFA Nations League,Belgium,18,11,2020,2,-2,6,4062,1,1,Belgium,Denmark,0,2,0.0427,0.71961,13,winner,loser
Belgium,Wales,3,1,FIFA World Cup qualification,Belgium,24,3,2021,2,-2,4,4063,1,0,Belgium,Wales,1,2,0.1705,0.36661,13,winner,loser
Japan,South Korea,3,0,Friendly,Japan,25,3,2021,3,-3,3,4064,0,0,Japan,South_Korea,1,3,0.13813,0.15679,13,winner,loser
Wales,Mexico,1,0,Friendly,Wales,27,3,2021,1,-1,1,4065,0,1,Wales,Mexico,1,1,0.67722,0.1164,13,winner,loser
Serbia,Portugal,2,2,FIFA World Cup qualification,Serbia,27,3,2021,0,0,4,4066,1,1,Serbia,Portugal,1,0,0.2129,0.61041,13,draw,draw
Costa Rica,Mexico,0,1,Friendly,Austria,30,3,2021,-1,1,1,4067,1,1,Costa_Rica,Mexico,1,1,0.72059,0.10266,13,loser,winner
England,Poland,2,1,FIFA World Cup qualification,England,31,3,2021,1,-1,3,4068,1,0,England,Poland,1,1,0.68448,0.22567,13,winner,loser
Switzerland,United States,2,1,Friendly,Switzerland,30,5,2021,1,-1,3,4069,0,0,Switzerland,United_States,1,1,0.07459,0.3671,13,winner,loser
France,Wales,3,0,Friendly,France,2,6,2021,3,-3,3,4070,0,0,France,Wales,1,3,0.17892,0.67046,13,winner,loser
Germany,Denmark,1,1,Friendly,Austria,2,6,2021,0,0,2,4071,1,1,Germany,Denmark,1,0,0.94222,0.72701,13,draw,draw
Mexico,Costa Rica,0,0,CONCACAF Nations League,United States,3,6,2021,0,0,0,4072,1,1,Mexico,Costa_Rica,1,0,0.95111,0.96155,13,draw,draw
Spain,Portugal,0,0,Friendly,Spain,4,6,2021,0,0,0,4073,1,1,Spain,Portugal,1,0,0.59734,0.11084,13,draw,draw
Brazil,Ecuador,2,0,FIFA World Cup qualification,Brazil,4,6,2021,2,-2,2,4074,0,0,Brazil,Ecuador,1,2,0.12508,0.0206,13,winner,loser
Belgium,Croatia,1,0,Friendly,Belgium,6,6,2021,1,-1,1,4075,1,0,Belgium,Croatia,1,1,0.64859,0.68444,13,winner,loser
United States,Mexico,3,2,CONCACAF Nations League,United States,6,6,2021,1,-1,5,4076,0,1,United_States,Mexico,1,1,0.40434,0.53777,13,winner,loser
Morocco,Ghana,1,0,Friendly,Morocco,8,6,2021,1,-1,1,4077,0,0,Morocco,Ghana,1,1,0.60092,0.13843,13,winner,loser
United States,Costa Rica,4,0,Friendly,United States,9,6,2021,4,-4,4,4078,0,1,United_States,Costa_Rica,1,4,0.15893,0.42266,13,winner,loser
Japan,Serbia,1,0,Kirin Challenge Cup,Japan,11,6,2021,1,-1,1,4079,0,1,Japan,Serbia,1,1,0.82384,0.89246,13,winner,loser
Wales,Switzerland,1,1,UEFA Euro,Wales,12,6,2021,0,0,2,4080,0,0,Wales,Switzerland,1,0,0.57398,0.321,13,draw,draw
England,Croatia,1,0,UEFA Euro,England,13,6,2021,1,-1,1,4081,1,0,England,Croatia,1,1,0.39718,0.71817,13,winner,loser
Germany,France,0,1,UEFA Euro,Germany,15,6,2021,-1,1,1,4082,1,0,Germany,France,1,1,0.64605,0.41983,13,loser,winner
Denmark,Belgium,1,2,UEFA Euro,Denmark,17,6,2021,-1,1,3,4083,1,1,Denmark,Belgium,1,1,0.82239,0.83981,13,loser,winner
Argentina,Uruguay,1,0,Copa America,Brazil,18,6,2021,1,-1,1,4084,1,1,Argentina,Uruguay,1,1,0.72327,0.05317,13,winner,loser
Spain,Poland,1,1,UEFA Euro,Spain,19,6,2021,0,0,2,4085,1,0,Spain,Poland,1,0,0.66043,0.53774,13,draw,draw
Germany,Portugal,4,2,UEFA Euro,Germany,19,6,2021,2,-2,6,4086,1,1,Germany,Portugal,1,2,0.46905,0.32708,13,winner,loser
Portugal,France,2,2,UEFA Euro,Hungary,23,6,2021,0,0,4,4087,1,0,Portugal,France,1,0,0.34905,0.971,13,draw,draw
Wales,Denmark,0,4,UEFA Euro,Netherlands,26,6,2021,-4,4,4,4088,0,1,Wales,Denmark,1,4,0.36485,0.87609,13,loser,winner
Belgium,Portugal,1,0,UEFA Euro,Spain,27,6,2021,1,-1,1,4089,1,1,Belgium,Portugal,1,1,0.32358,0.65323,13,winner,loser
Brazil,Ecuador,1,1,Copa America,Brazil,27,6,2021,0,0,2,4090,0,0,Brazil,Ecuador,1,0,0.97469,0.95078,13,draw,draw
Croatia,Spain,3,5,UEFA Euro,Denmark,28,6,2021,-2,2,8,4091,0,1,Croatia,Spain,1,2,0.94374,0.41407,13,loser,winner
France,Switzerland,3,3,UEFA Euro,Romania,28,6,2021,0,0,6,4092,0,0,France,Switzerland,1,0,0.81012,0.88746,13,draw,draw
England,Germany,2,0,UEFA Euro,England,29,6,2021,2,-2,2,4093,1,1,England,Germany,1,2,0.89448,0.84159,13,winner,loser
Switzerland,Spain,1,1,UEFA Euro,Russia,2,7,2021,0,0,2,4094,0,1,Switzerland,Spain,1,0,0.35544,0.38393,13,draw,draw
Argentina,Ecuador,3,0,Copa America,Brazil,3,7,2021,3,-3,3,4095,1,0,Argentina,Ecuador,1,3,0.63115,0.48733,13,winner,loser
England,Denmark,2,1,UEFA Euro,England,7,7,2021,1,-1,3,4096,1,1,England,Denmark,1,1,0.99982,0.5467,13,winner,loser
Brazil,Argentina,0,1,Copa America,Brazil,10,7,2021,-1,1,1,4097,0,1,Brazil,Argentina,1,1,0.19526,0.53676,13,loser,winner
United States,Canada,1,0,Gold Cup,United States,18,7,2021,1,-1,1,4098,0,0,United_States,Canada,1,1,0.99662,0.51388,13,winner,loser
Costa Rica,Canada,0,2,Gold Cup,United States,25,7,2021,-2,2,2,4099,1,0,Costa_Rica,Canada,1,2,0.89352,0.68084,13,loser,winner
Mexico,Canada,2,1,Gold Cup,United States,29,7,2021,1,-1,3,4100,1,0,Mexico,Canada,1,1,0.12207,0.81254,13,winner,loser
United States,Qatar,1,0,Gold Cup,United States,29,7,2021,1,-1,1,4101,0,0,United_States,Qatar,1,1,0.11449,0.51961,13,winner,loser
United States,Mexico,1,0,Gold Cup,United States,1,8,2021,1,-1,1,4102,0,1,United_States,Mexico,1,1,0.71377,0.53597,13,winner,loser
Qatar,Serbia,0,4,Friendly,Hungary,1,9,2021,-4,4,4,4103,0,1,Qatar,Serbia,1,4,0.93482,0.54792,13,loser,winner
Qatar,Portugal,1,3,Friendly,Hungary,4,9,2021,-2,2,4,4104,0,1,Qatar,Portugal,1,2,0.4601,0.96491,13,loser,winner
Costa Rica,Mexico,0,1,FIFA World Cup qualification,Costa Rica,5,9,2021,-1,1,1,4105,1,1,Costa_Rica,Mexico,1,1,0.26909,0.71738,13,loser,winner
United States,Canada,1,1,FIFA World Cup qualification,United States,5,9,2021,0,0,2,4106,0,0,United_States,Canada,1,0,0.75544,0.76118,13,draw,draw
Poland,England,1,1,FIFA World Cup qualification,Poland,8,9,2021,0,0,2,4107,0,1,Poland,England,1,0,0.54767,0.00854,13,draw,draw
Uruguay,Ecuador,1,0,FIFA World Cup qualification,Uruguay,9,9,2021,1,-1,1,4108,1,0,Uruguay,Ecuador,1,1,0.3828,0.33748,13,winner,loser
Saudi Arabia,Japan,1,0,FIFA World Cup qualification,Saudi Arabia,7,10,2021,1,-1,1,4109,1,0,Saudi_Arabia,Japan,1,1,0.57197,0.54493,13,winner,loser
Mexico,Canada,1,1,FIFA World Cup qualification,Mexico,7,10,2021,0,0,2,4110,1,0,Mexico,Canada,1,0,0.4118,0.84312,13,draw,draw
Belgium,France,2,3,UEFA Nations League,Italy,7,10,2021,-1,1,5,4111,1,0,Belgium,France,1,1,0.98335,0.34041,13,loser,winner
Portugal,Qatar,3,0,Friendly,Portugal,9,10,2021,3,-3,3,4112,1,0,Portugal,Qatar,1,3,0.55875,0.50625,13,winner,loser
Argentina,Uruguay,3,0,FIFA World Cup qualification,Argentina,10,10,2021,3,-3,3,4113,1,1,Argentina,Uruguay,1,3,0.70488,0.11489,13,winner,loser
Spain,France,1,2,UEFA Nations League,Italy,10,10,2021,-1,1,3,4114,1,0,Spain,France,1,1,0.26712,0.12174,13,loser,winner
Iran,South Korea,1,1,FIFA World Cup qualification,Iran,12,10,2021,0,0,2,4115,1,0,Iran,South_Korea,1,0,0.25794,0.19326,13,draw,draw
Japan,Australia,2,1,FIFA World Cup qualification,Japan,12,10,2021,1,-1,3,4116,0,0,Japan,Australia,1,1,0.6139,0.49615,13,winner,loser
United States,Costa Rica,2,1,FIFA World Cup qualification,United States,13,10,2021,1,-1,3,4117,0,1,United_States,Costa_Rica,1,1,0.98699,0.03639,13,winner,loser
Brazil,Uruguay,4,1,FIFA World Cup qualification,Brazil,14,10,2021,3,-3,5,4118,0,1,Brazil,Uruguay,1,3,0.28254,0.11663,13,winner,loser
Mexico,Ecuador,2,3,Friendly,United States,27,10,2021,-1,1,5,4119,1,0,Mexico,Ecuador,1,1,0.88909,0.20805,13,loser,winner
Serbia,Qatar,4,0,Friendly,Serbia,11,11,2021,4,-4,4,4120,1,0,Serbia,Qatar,1,4,0.16609,0.20089,13,winner,loser
Australia,Saudi Arabia,0,0,FIFA World Cup qualification,Australia,11,11,2021,0,0,0,4121,0,1,Australia,Saudi_Arabia,1,0,0.96086,0.88085,13,draw,draw
Canada,Costa Rica,1,0,FIFA World Cup qualification,Canada,12,11,2021,1,-1,1,4122,0,1,Canada,Costa_Rica,1,1,0.09451,0.7946,13,winner,loser
United States,Mexico,2,0,FIFA World Cup qualification,United States,12,11,2021,2,-2,2,4123,0,1,United_States,Mexico,1,2,0.44225,0.28991,13,winner,loser
Uruguay,Argentina,0,1,FIFA World Cup qualification,Uruguay,12,11,2021,-1,1,1,4124,1,1,Uruguay,Argentina,1,1,0.30372,0.64268,13,loser,winner
Portugal,Serbia,1,2,FIFA World Cup qualification,Portugal,14,11,2021,-1,1,3,4125,1,1,Portugal,Serbia,1,1,0.6022,0.08854,13,loser,winner
Canada,Mexico,2,1,FIFA World Cup qualification,Canada,16,11,2021,1,-1,3,4126,0,1,Canada,Mexico,1,1,0.00902,0.32199,13,winner,loser
Wales,Belgium,1,1,FIFA World Cup qualification,Wales,16,11,2021,0,0,2,4127,0,1,Wales,Belgium,1,0,0.59601,0.91859,13,draw,draw
Argentina,Brazil,0,0,FIFA World Cup qualification,Argentina,16,11,2021,0,0,0,4128,1,0,Argentina,Brazil,1,0,0.21923,0.18991,13,draw,draw
Morocco,Saudi Arabia,1,0,Arab Cup,Qatar,7,12,2021,1,-1,1,4129,0,1,Morocco,Saudi_Arabia,1,1,0.41171,0.39679,13,winner,loser
Morocco,Ghana,1,0,African Cup of Nations,Cameroon,10,1,2022,1,-1,1,4130,0,0,Morocco,Ghana,2,1,0.02,0.02924,13,winner,loser
Ecuador,Brazil,1,1,FIFA World Cup qualification,Ecuador,27,1,2022,0,0,2,4131,0,0,Ecuador,Brazil,2,0,0.65613,0.86113,13,draw,draw
Canada,United States,2,0,FIFA World Cup qualification,Canada,30,1,2022,2,-2,2,4132,0,0,Canada,United_States,2,2,0.45625,0.30408,13,winner,loser
Mexico,Costa Rica,0,0,FIFA World Cup qualification,Mexico,30,1,2022,0,0,0,4133,1,1,Mexico,Costa_Rica,2,0,0.7503,0.84112,13,draw,draw
Japan,Saudi Arabia,2,0,FIFA World Cup qualification,Japan,1,2,2022,2,-2,2,4134,0,1,Japan,Saudi_Arabia,2,2,0.80496,0.37224,13,winner,loser
Mexico,United States,0,0,FIFA World Cup qualification,Mexico,24,3,2022,0,0,0,4135,1,0,Mexico,United_States,2,0,0.73469,0.8548,13,draw,draw
Costa Rica,Canada,1,0,FIFA World Cup qualification,Costa Rica,24,3,2022,1,-1,1,4136,1,0,Costa_Rica,Canada,2,1,0.48294,0.59493,13,winner,loser
South Korea,Iran,2,0,FIFA World Cup qualification,South Korea,24,3,2022,2,-2,2,4137,0,1,South_Korea,Iran,2,2,0.38911,0.92841,13,winner,loser
Australia,Japan,0,2,FIFA World Cup qualification,Australia,24,3,2022,-2,2,2,4138,0,0,Australia,Japan,2,2,0.97189,0.58746,13,loser,winner
England,Switzerland,2,1,Friendly,England,26,3,2022,1,-1,3,4139,1,0,England,Switzerland,2,1,0.1642,0.81222,13,winner,loser
Netherlands,Denmark,4,2,Friendly,Netherlands,26,3,2022,2,-2,6,4140,1,1,Netherlands,Denmark,2,2,0.91204,0.66333,13,winner,loser
Saudi Arabia,Australia,1,0,FIFA World Cup qualification,Saudi Arabia,29,3,2022,1,-1,1,4141,1,0,Saudi_Arabia,Australia,2,1,0.43753,0.99531,13,winner,loser
Ecuador,Argentina,1,1,FIFA World Cup qualification,Ecuador,29,3,2022,0,0,2,4142,0,1,Ecuador,Argentina,2,0,0.14443,0.0161,13,draw,draw
Denmark,Serbia,3,0,Friendly,Denmark,29,3,2022,3,-3,3,4143,1,1,Denmark,Serbia,2,3,0.45405,0.19299,13,winner,loser
Netherlands,Germany,1,1,Friendly,Netherlands,29,3,2022,0,0,2,4144,1,1,Netherlands,Germany,2,0,0.57237,0.56088,13,draw,draw
Costa Rica,United States,2,0,FIFA World Cup qualification,Costa Rica,30,3,2022,2,-2,2,4145,1,0,Costa_Rica,United_States,2,2,0.60969,0.32729,13,winner,loser
Poland,Wales,2,1,UEFA Nations League,Poland,1,6,2022,1,-1,3,4146,0,0,Poland,Wales,2,1,0.68877,0.65442,13,winner,loser
United States,Morocco,3,0,Friendly,United States,1,6,2022,3,-3,3,4147,0,0,United_States,Morocco,2,3,0.51579,0.83811,13,winner,loser
Spain,Portugal,1,1,UEFA Nations League,Spain,2,6,2022,0,0,2,4148,1,1,Spain,Portugal,2,0,0.66961,0.96089,13,draw,draw
South Korea,Brazil,1,5,Friendly,South Korea,2,6,2022,-4,4,6,4149,0,0,South_Korea,Brazil,2,4,0.8131,0.83356,13,loser,winner
Mexico,Uruguay,0,3,Friendly,United States,2,6,2022,-3,3,3,4150,1,1,Mexico,Uruguay,2,3,0.63254,0.47456,13,loser,winner
France,Denmark,1,2,UEFA Nations League,France,3,6,2022,-1,1,3,4151,0,1,France,Denmark,2,1,0.20582,0.83846,13,loser,winner
Belgium,Netherlands,1,4,UEFA Nations League,Belgium,3,6,2022,-3,3,5,4152,1,1,Belgium,Netherlands,2,3,0.33331,0.48004,13,loser,winner
Portugal,Switzerland,4,0,UEFA Nations League,Portugal,5,6,2022,4,-4,4,4153,1,0,Portugal,Switzerland,2,4,0.85519,0.57711,13,winner,loser
Mexico,Ecuador,0,0,Friendly,United States,5,6,2022,0,0,0,4154,1,0,Mexico,Ecuador,2,0,0.59108,0.6284,13,draw,draw
United States,Uruguay,0,0,Friendly,United States,5,6,2022,0,0,0,4155,0,1,United_States,Uruguay,2,0,0.92819,0.06901,13,draw,draw
Croatia,France,1,1,UEFA Nations League,Croatia,6,6,2022,0,0,2,4156,0,0,Croatia,France,2,0,0.3061,0.83559,13,draw,draw
Japan,Brazil,0,1,Friendly,Japan,6,6,2022,-1,1,1,4157,0,0,Japan,Brazil,2,1,0.04938,0.17701,13,loser,winner
Germany,England,1,1,UEFA Nations League,Germany,7,6,2022,0,0,2,4158,1,1,Germany,England,2,0,0.63809,0.26211,13,draw,draw
Wales,Netherlands,1,2,UEFA Nations League,Wales,8,6,2022,-1,1,3,4159,0,1,Wales,Netherlands,2,1,0.37271,0.35349,13,loser,winner
Belgium,Poland,6,1,UEFA Nations League,Belgium,8,6,2022,5,-5,7,4160,1,0,Belgium,Poland,2,5,0.83966,0.57779,13,winner,loser
Switzerland,Spain,0,1,UEFA Nations League,Switzerland,9,6,2022,-1,1,1,4161,0,1,Switzerland,Spain,2,1,0.52649,0.61813,13,loser,winner
Denmark,Croatia,0,1,UEFA Nations League,Denmark,10,6,2022,-1,1,1,4162,1,0,Denmark,Croatia,2,1,0.49006,0.58239,13,loser,winner
Japan,Ghana,4,1,Kirin Cup,Japan,10,6,2022,3,-3,5,4163,0,0,Japan,Ghana,2,3,0.11873,0.53041,13,winner,loser
Wales,Belgium,1,1,UEFA Nations League,Wales,11,6,2022,0,0,2,4164,0,1,Wales,Belgium,2,0,0.35807,0.98476,13,draw,draw
Netherlands,Poland,2,2,UEFA Nations League,Netherlands,11,6,2022,0,0,4,4165,1,0,Netherlands,Poland,2,0,0.40747,0.90325,13,draw,draw
Switzerland,Portugal,1,0,UEFA Nations League,Switzerland,12,6,2022,1,-1,1,4166,0,1,Switzerland,Portugal,2,1,0.00493,0.92358,13,winner,loser
France,Croatia,0,1,UEFA Nations League,France,13,6,2022,-1,1,1,4167,0,0,France,Croatia,2,1,0.72062,0.50958,13,loser,winner
Netherlands,Wales,3,2,UEFA Nations League,Netherlands,14,6,2022,1,-1,5,4168,1,0,Netherlands,Wales,2,1,0.75019,0.28707,13,winner,loser
Poland,Belgium,0,1,UEFA Nations League,Poland,14,6,2022,-1,1,1,4169,0,1,Poland,Belgium,2,1,0.08453,0.97991,13,loser,winner
Japan,Tunisia,0,3,Kirin Cup,Japan,14,6,2022,-3,3,3,4170,0,1,Japan,Tunisia,2,3,0.76254,0.88982,13,loser,winner
Brazil,Tunisia,5,1,Friendly,France,27,9,2022,4,-4,6,4171,0,1,Brazil,Tunisia,2,4,0.04125,0.64794,13,winner,loser
Canada,Uruguay,0,2,Friendly,Slovakia,27,9,2022,-2,2,2,4172,0,1,Canada,Uruguay,2,2,0.35476,0.1302,13,loser,winner
Saudi Arabia,United States,0,0,Friendly,Spain,27,9,2022,0,0,0,4173,1,0,Saudi_Arabia,United_States,2,0,0.11843,0.79355,13,draw,draw
South Korea,Cameroon,1,0,Friendly,South Korea,27,9,2022,1,-1,1,4174,0,1,South_Korea,Cameroon,2,1,0.73299,0.8526,13,winner,loser
Japan,Ecuador,0,0,Copa America,Brazil,27,9,2022,0,0,0,4175,0,0,Japan,Ecuador,2,0,0.54576,0.2796,13,draw,draw
Senegal,Iran,1,1,Friendly,Austria,27,9,2022,0,0,2,4176,0,1,Senegal,Iran,2,0,0.33367,0.94873,13,draw,draw
Iran,Uruguay,1,0,Friendly,Austria,23,9,2022,1,-1,1,4177,1,1,Iran,Uruguay,2,1,0.48409,0.89574,13,winner,loser
Canada,Qatar,2,0,Friendly,Austria,23,9,2022,2,-2,2,4178,0,0,Canada,Qatar,2,2,0.74536,0.11743,13,winner,loser
Ecuador,Saudi Arabia,0,0,Friendly,Spain,23,9,2022,0,0,0,4179,0,1,Ecuador,Saudi_Arabia,2,0,0.87663,0.92768,13,draw,draw
Brazil,Ghana,3,0,Friendly,France,23,9,2022,3,-3,3,4180,0,0,Brazil,Ghana,2,3,0.12343,0.35802,13,winner,loser
South Korea,Costa Rica,2,2,Friendly,South Korea,23,9,2022,0,0,4,4181,0,1,South_Korea,Costa_Rica,2,0,0.85933,0.38276,13,draw,draw
Japan,United States,2,0,Friendly,Germany,23,9,2022,2,-2,2,4182,0,0,Japan,United_States,2,2,0.87363,0.81756,13,winner,loser